ก
กฏัตตากรรม	Kañattākamma
กฐิน	Kañhina
กตเวที	Katavedī
กตัญญุตา	Kataññutā
กตัญญู	Kataññū
กตัญญูกตเวทิตา	Kataññūkataveditā
กตัญญูกตเวที	Kataññūkatavedī
กตัตตากรรม ดู กฏัตตากรรม
กถาวัตถุ	Kathāvatthu
กรมการศาสนา	Sāsanādhikāra*
กรรม	Kamma
กรรมกิเลส	Kammakilesa
กรรมฐาน	Kammaññhāna
กรรมนิยาม	Kammaniyāma
กรรมบถ	Kammapatha
กรรมภพ	Kammabhava
กรรมวาจา	Kammavācā
กรรมวาจาจารย์	Kammavācācariya
กรวดนํ้ า, การ	Dakkhiṇodakapātana
กระถางธูป	Dhūpabhājana*
กระทู้	Nikkhepapada
กราน	Attharati
กราบ	Abhivāda
กรุณา	Karuṇā
กลด1	Mahāchatta
กลด2	Dussakuñikā
กลละ	Kalala
กษัตริย์	Khattiya
กสิณ	Kasiṇa
กังขา	Kaṅkhā
กัณฑ์	Kaṇóa
กัณฑ์เทศน์	Dhammadesanāpūjā*, Dhammakathikadeyya*
กัป, กัปป์, กัลป์	Kappa
กัปปพินทุ	Kappabindu
กัปปิยการก	Kappiyakāraka
กัมม- ดู กรรม-.
กัลปนา	Kappanā
กัลยาณมิตตตา	Kalyāṇamittatā
กาม	Kāma
กามคุณ	Kāmaguṇa
กามฉันท์	Kāmachanda
กามตัณหา	Kāmataṇhā
กามภพ	Kāmabhava
กามราคะ	Kāmarāga
กามโลก	Kāmaloka
กามวิตก	Kāmavitakka
กามสังวร	Kāmasaṁvara
กามสุข	Kāmasukha
กามสุขัลลิกานุโยค	Kāmasukhallikānuyoga
กามาวจร	Kāmāvacara
กามาวจรภูมิ	Kāmāvacarabhūmi
กามุปาทาน	Kāmupādāna
กาเมสุมิจฉาจาร	Kāmesumicchācāra
กาย	Kāya
กายกรรม	Kāyakamma
กายคตาสติ	Kāyagatāsati
กายทวาร	Kāyadvāra
กายทุจริต	Kāyaduccarita
กายวิญญัติ	Kāyaviññatti
กายวิญญาณ	Kāyaviññāṇa
กายวิเวก	Kāyaviveka
กายสังขาร	Kāyasaṅkhāra
กายสัมผัส	Kāyasamphassa
กายสุจริต	Kāyasucarita
กายานุปัสสนา	Kāyānupassanā
กายิกทุกข์	Kāyikadukkha
กายิกสุข	Kāyikasukha
การเปรียญ	Dhammasālā
กาลมรณะ	Kālamaraṇa
กาลัญญุตา	Kālaññutā
กาสาวพัสตร์	Kāsāya, Kāsāvavattha
กำเนิด ดู โยนิ.
กำแพงแก้ว	Ratanapākāra
กิงฺกรณีเยสุ ทกฺขตา	Kiṅkaraṇīyesu dakkhatā
กิจจาธิกรณ์	Kiccādhikaraṇa
กิจวัตร	Kiccavatta*
กิริยาจิต	Kiriyācitta
กิเลส	Kilesa
กิเลสกาม	Kilesakāma
กุกกุจจะ	Kukkucca
กุฎี	Kuñī
กุลุปกะ	Kulupaka
กุศล	Kusala
กุศลกรรม	Kusalakamma
กุศลกรรมบถ	Kusalakammapatha
กุศลจิต	Kusalacitta
กุศลเจตนา	Kusalacetanā
กุศลมูล	Kusalamūla
กุศลวิตก	Kusalavitakka
กุหนา	Kuhanā
เกตุมาลา	Ketumālā
เกิดใหม่ ดู ชาติหน้า.
โกธะ, โกรธ	Kodha
โกศ	Kosa*
โกสัชชะ	Kosajja
ข
ขณะจิต	Cittakkhaṇa
ขณิกสมาธิ	Khaṇikasamādhi
ขณิกาปีติ	Khaṇikāpīti
ขมา	Khamā
ขมา, การขอ	Khamāpana
ของขลัง	Parittavatthu, Indajālikavatthu*
ขัดสมาธิ	Pallaṅkaṁ ābhujati
ขันติ	Khanti
ขันธ์	Khandha
ขันธ์ห้า ดู เบญจขันธ์.
ข้างขึ้น	Juṇha-pakkha, Sukka-~
ข้างแรม	Kaṇha-pakkha, Kāḷa-~
ขาทนียะ	Khādanīya
ขีณาสพ	Khīṇāsava
ขุททกนิกาย	Khuddakanikāya
ขุททกปาฐะ	Khuddakapāñha
“Text of Small Passages”; name of the first  division of the Khuddaka Nikāya.
ขุททกาปีติ	Khuddakāpīti
เข้าพรรษา ดู วันเข้าพรรษา.
เขี้ยวแก้ว ดู ทาฐธาตุ.
ค
คณะ	Gaṇa
คณปูรกะ	Gaṇapūraka
คณะวินัยธร	Vinayadhara-gaṇa, ~-samajjā*
คณะสงฆ์	Saṅgha
คณะสังฆมนตรี	Saṅghamanti-gaṇa, ~-samajjā*
คติ	Gati
คนธรรพ์	Gandhabba
ครองผ้า	Nivāseti, Pārupati
ครุกกรรม	Garukakamma
ครุฏฐานียบุคคล	Garuññhānīyapuggala
ครุธรรม	Garudhamma
คฤหัสถ์	Gahaññha
ควํ่ าบาตร, การ	Pattanikujjanā
คันถธุระ	Ganthadhura
คันธะ	Gandha
คัมภีร์	Gantha, Potthaka, Pakaraṇa
คาถา	Gāthā
คามวาสี	Gāmavāsī
คารวะ	Gārava
คิดปรุงแต่ง	Saṅkharoti; Abhisaṅkharoti
คิลานปัจจัย	Gilānapaccaya
คิลานเภสัช	Gilānabhesajja
คิหิปฏิบัติ	Gihipañipatti*
คุกเข่า	Jannukāhi nipatati
คุณ	Guṇa
คุณธรรม	Guṇadhamma
คุณพิเศษ, คุณวิเศษ	Visesa
คู่สวด	Upasampadācariya, Kammavācācariya +  Anusāvanācariya
เครื่องราง	Indajālikavatthu*
โคจร	Gocara
โคจรคาม	Gocaragāma
โคดม, โคตมะ	Gotama
โคตร	Gotta
ฆ–ง
ฆนสัญญา	Ghanasaññā
ฆราวาส	Gharāvāsa
ฆราวาสธรรม	Gharāvāsa-dhamma
ฆานะ	Ghāna
ฆานทวาร	Ghānadvāra
ฆานวิญญาณ	Ghānaviññāṇa
โฆสัปปมาณิกา	Ghosappamāṇikā
งานมงคล	Maṅgala, Maṅgala-samaya
งานวัด (Cetiyamahāpūjā*, Vihārasamajja*, 
~ussava*, ~maha*) temple fair.
งานศพ	Sarīrajjhāpana
งานสมรส	Vivāhakāla, Vivāhamaṅgala
งานอวมงคล	Avamaṅgala,  Petadakkhiṇādāna
จ
จงกรม	Caṅkama
จตุตถฌาน	Catutthajjhāna
จตุธาตุววัตถาน	Catudhātuvavatthāna
จตุปัจจัย	Catupaccaya
จตุรพิธพร	Catubbidhavara*
จตุราริยสัจจ์	Cattāri Ariyasaccāni
จตุวรรค	Catuvagga
จรณะ	Caraṇa
จริต	Carita
จริยาปิฎก	Cariyāpiñaka
จริยาวัตร	Cariyāvatta*
จักขุ, จักษุ	Cakkhu
จักขุทวาร	Cakkhudvāra
จักขุวิญญาณ	Cakkhuviññāṇa
จักร, จักรธรรม	Cakka
จักรพรรดิ	Cakkavatti
จักรวาฬ	Cakkavāḷa
จัณฑาล	Caṇóāla
จันทรคติ	Candagati*
จาคะ	Cāga
จาคสัมปทา	Cāgasampadā
จาคานุสติ	Cāgānussati
จาตุทสี	Cātuddasī
จาตุมหาราช	Cātummahārājikā
จาตุรงคสันนิบาต	Cāturaṅgasannipāta
จาริก	Cārika
จารึก	Likhati
จำพรรษา, การ	Vassāvāsa
จำวัด	Seyyaṁ kappeti
จิต, จิตต์	Citta
จิตกาธาน	Citakā
จิตตะ	Citta
จิตตนิยาม	Cittaniyāma
จิตตวิสุทธิ	Cittavisuddhi
จิตตสังขาร	Cittasaṅkhāra
จิตตานุปัสสนา	Cittānupassanā
จิตตุบาท, จิตตุปปาท	Cittuppāda
จินตมยปัญญา	Cintamayapaññā
จีวร	Cīvara
จีวรอธิษฐาน	Adhiññhitacīvara
จีวรอาศัย	Atirekacīvara
จุติ	Cuti
จุติจิต	Cuticitta
จุติวิญญาณ	Cutiviññāṇa
จุตูปปาตญาณ	Cutūpapātañāṇa
จุลลวรรค	Cullavagga
เจดีย์	Cetiya
เจตนา	Cetanā
เจตภูต	Attā, Jīva
เจตสิก	Cetasika
เจตสิกทุกข์	Cetasikadukkha
เจตสิกสุข	Cetasikasukha
เจโตปริยญาณ	Cetopariyañāṇa
เจโตวิมุตติ	Cetovimutti
เจริญพระพุทธมนต์	Parittabhaṇana
เจ้าคณะ	Gaṇādhipati*
เจ้าคณะจังหวัด	Nagarasaṅghapāmokkha*
เจ้าคณะตำบล	Gāmasamūhasaṅghādhipati*
เจ้าคณะภาค	Cūḷasaṅghamaṇóalapāmokkha*
เจ้าคณะใหญ่	Mahāsaṅghamaṇóalapāmokkha*
เจ้าคณะอำเภอ	Nigamasaṅghādhipati*
เจ้าคุณ	Guṇassāmī*
“Chao Khun”; “The Right Venerable”. ดู พระ- 
ราชาคณะ
เจ้าภาพ	Nimantaka, Dānapati
เจ้าอธิการ	Vihārādhipati*, Adhikārapati*
เจ้าอาวาส	Vihārapati*
เจิม	Abbhañjati
แจกัน	pupphādhāna*
แจง	Saṅgītikathā*
โจทก์	Codaka
โจทนา	Codanā
ฉ
ฉกามาพจรสวรรค์	Chakāmāvacaradevaloka
ฉลอง	Mahakamma
ฉฬภิญญา	Chaḷabhiññā
ฉัตร	Chatta
ฉัน	Bhuñjati
ฉันทะ	Chanda
ฉันท์	Chanda
ฉันทาคติ	Chandāgati
ฉัพพัณณรังสี	Chabbaṇṇaraṁsī
ฉายา	Chāyā
เฉวียง	Ekaṁsaṁ
ช
ชฎิล	Jañila
ชนกกรรม	Janakakamma
ชมพูทวีป	Jambūdīpa
ชรา	Jarā
ชลาพุชะ	Jalābuja
ชวนะ	Javana
ช่อฟา	Kaṇṇikā, Kūñapilandhana*
ชักผ้า ดู บังสุกุล, ผ้าป่า.
ชัยมงคลคาถา	Jayamaṅgalagāthā
ชาคริยานุโยค	Jāgariyānuyoga
ชาดก	Jātaka
ชาติ	Jāti
ชาติก่อน	Atītabhava
ชาติหน้า	Paraloka, punabbhava
ชินะ	Jina
ชินบุตร, ชิโนรส	Jinaputta, Jinorasa
ชิวหา	Jivhā
ชิวหาทวาร	Jivhādvāra
ชิวหาวิญญาณ	Jivhāviññāṇa
ชี	Muṇóakaupāsikā*
ชีวิต	Jīvita
ชีวิตินทรีย์	Jīvitindriya
ชุกชี	Mahāpañimā-patiññhāna
เชิงตะกอน ดู จิตกาธาน.
เชิงเทียน	Sitthadīpādhāra*
เชิงบาตร	Pattādhāraka
ฌ
ฌาน	Jhāna
ฌาปนกิจ	Jhāpanakicca
ฌาปนสถาน	Jhāpanaññhāna
ญ
ญัตติ, ญัติ	¥atti
ญาณ	¥āṇa
ญาณทัศนะ	¥āṇadassana
ญาณทัสสนวิสุทธิ	¥āṇadassana-visuddhi
ญาติ	¥āti
ญาติพลี	¥ātibali
ญาติสังคหะ	¥ātisaṅgaha
ญาติสาโลหิต	¥ātisālohita
ญายะ, ญายธรรม	¥āya
เญยยธรรม, ไญยธรรม	¥eyyadhamma
ฎ
ฎีกา	òīkā
ฐ
ฐาน	òhāna*
ฐานานุกรม	òhānānukkama*
ฐานานุศักดิ์	òhānānusatti
ฐิติ	òhiti, òhīti
ณ
เณร ดู สามเณร.
ด
ดวงตาเห็นธรรม ดู ธรรมจักษุ.
ดาบส	Tāpasa
ดาวดึงส์	Tāvatiṁsā
ดิรัจฉาน, กำเนิด ดู ติรัจฉานโยนิ.
ดุสิต	Tusitā
เด็กวัด	ârāmika; ârāmika-kumāra; Daharārāmika; Kappiyakāraka
เดียรถีย์	Titthiya
ต
ตจปัญจกกัมมัฏฐาน	Tacapañcaka-kammaññhāna
มูลกรรมฐาน ก็เรียก.
ตติยฌาน	Tatiyajjhāna
ตถาคต	Tathāgata
ตทังคปหาน	Tadaṅgapahāna
ตทังควิมุตติ	Tadaṅgavimutti
ตบะ	Tapa
ตรัสรู้	Bodhi
ตราตั้ง	Adhikārapañña*
สัญญาบัตร.
ตลกบาตร ดู ถลกบาตร.
ตักบาตร	Piṇóadāna
ตัชชนียกรรม	Tajjanīyakamma
ตัณหา	Taṇhā
ตัตรมัชฌัตตตา	Tatramajjhattatā
ตัสสปาปิยสิกา	Tassapāpiyasikā
ตาลปัตร	Tālapatta
ตำนาน	Vaṁsa
ติณวัตถารกวินัย	Tiṇavatthārakavinaya
ติรัจฉานกถา	Tiracchānakathā
ติรัจฉานโยนิ	Tiracchānayoni
ติรัจฉานวิชา	Tiracchānavijjā
ติสรณคมนูปสัมปทา	Tisaraṇagamanūpasampadā
เตโชกสิณ	Tejokasiṇa
เตโชธาตุ	Tejodhātu
เตวาจิก	Tevācika
โตะหมู่บูชา	Pūjanapīñha*
ไตรจีวร	Ticīvara
ไตรทวาร	Tidvāra
ไตรปิฎก	Tepiñaka
ไตรเพท	Tiveda
ไตรภพ, ไตรภูมิ	Tibhava, Tebhūmi
ไตรมาส	Temāsa
ไตรรัตน์	Ratanattaya
ไตรลักษณ์	Tilakkhaṇa
ลักษณะ.
ไตรโลก	Tiloka
ไตรสรณะ	Tisaraṇa
ไตรสรณคมน์	Tisaraṇagamana
ไตรสิกขา	Sikkhāttaya
ถ
ถลกบาตร	Pattathavikā
ถวาย	Deti
ถวายพระเพลิง	Sarīrajjhāpana
ถัมภะ	Thambha
ถาน	Vaccakuñī
ถีนะ	Thīna
ถีนมิทธะ	Thīnamiddha
ถุลลัจจัย	Thullaccaya
ถูปารหบุคคล	Thūpārahapuggala
เถน	Thena
เถยจิต	Theyyacitta
เถยเจตนา	Theyyacetanā
เถยสังวาส	Theyyasaṁvāsa
เถระ	Thera
เถรคาถา	Theragāthā
“Verses of the Elders”; name of the eighth  division of the Khuddaka Nikāya.
เถรวาท	Theravāda
เถรานุเถระ	Therānuthera
เถรี	Therī
เถรีคาถา	Therīgāthā
“Verses of the Women Elders”; name of the  ninth division of the Khuddaka Nikāya.
ท
ทธิ	Dadhi
ทมะ	Dama
ทวาร	Dvāra
ทศชาติ	Dasajāti
ทศบารมี	Dasapāramī
ทศพร	Dasavara
ทศพล	Dasabala
ทศพลญาณ	Dasabalañāṇa
ทศพิธราชธรรม	Dasarājadhamma
ทองคำเปลว	Suvaṇṇapatta
ทอดกฐิน ดู กฐิน.
ทอดผ้า [บังสุกุล]	Paṁsukūlacīvaranikkhipana
ทอดผ้าป่า ดู ผ้าป่า.
ทักขิณา, ทักษิณา	Dakkhiṇā
ทักขิณาวัฏ	Dakkhiṇāvañña
ทักขิโณทก	Dakkhiṇodaka
ทักขิไณยบุคคล, ทักขิเณยยบุคคล	Dakkhiṇeyyapuggala
ทักษิณนิกาย	Dakkhiṇanikāya
ทักษิณานุประทาน	Dakkhiṇānuppadāna*
ทัณฑกรรม	Daṇóakamma
ทัศนะ, ทรรศนะ, ทัสสนะ	Dassana
ทัฬหีกรรม	Daḷhīkamma
ทาฐธาตุ	Dāñhadhātu
ทาน	Dāna
ทานบดี	Dānapati
ทานมัย	Dānamaya
ทายก	Dāyaka
ทายิกา	Dāyikā
ทำนองสวด	Vatta, Bhāṇassara*
ทำบุญ	Puññakaraṇa
ทำบุญขึ้นบ้านใหม่	Gehapañhamaparibhogamaṅgala*, Gehappavesana-maṅgala*
ทำบุญบ้าน	Gehamaṅgala*
ทำวัตรคํ่ า, ทำวัตรเย็น	Sāyaṇha-sajjhāya*, Sāyabhāṇa*
ทำวัตรเช้า	Pubbaṇha-sajjhāya*, Pāta-bhāṇa*
ทิฏฐธรรม	Diññhadhamma
ทิฏฐธรรมเวทนียกรรม	Diññhadhammavedanīyakamma
ทิฏฐธัมมิกัตถะ	Diññhadhammikattha
ทิฏฐาวิกัมม์	Diññhāvikamma
ทิฏฐิ, ทิฐิ	Diññhi
ทิฏฐิวิสุทธิ	Diññhivisuddhi
ทิฏฐิสามัญญตา	Diññhi-sāmaññatā
ทิฏุชุกรรม	Diññhujukamma
ทิฏุปาทาน	Diññhupādāna
ทิพพจักขุ	Dibbacakkhu
ทิพพโสตะ	Dibbasota
ทิพย์	Dibba
ทีฆนิกาย	Dīghanikāya
ที่กัลปนา	Kappanāvatthu*
ที่ธรณีสงฆ์	Saṅghikavatthu
ที่วัด	ârāmavatthu, Vihāravatthu
ที่สุด ดู อันตา.
ทุกกฏ	Dukkaña
ทุกข์	Dukkha
ทุกขตา	Dukkhatā
ทุกขนิโรธอริยสัจจ์	Dukkhanirodha Ariyasacca
ทุกขนิโรธคามินีปฏิปทาอริยสัจจ์	Dukkhanirodhagāminīpañipadā Ariyasacca
ทุกขเวทนา	Dukkhavedanā
ทุกขสมุทัยอริยสัจจ์	Dukkhasamudaya Ariyasacca
ทุกขอริยสัจจ์	Dukkha Ariyasacca
ทุกรกิริยา	Dukkarakiriyā
ทุคติ	Duggati
ทุจริต	Duccarita
ทุติยฌาน	Dutiyajjhāna
ทุพภาษิต	Dubbhāsita
ทุศีล	Dussīla
เทพ	Deva
เทวดา	Devatā
เทวตานุสติ	Devatānussati
เทวตาพลี	Devatābali
เทวทูต	Devadūta
เทวธรรม	Devadhamma
เทวรูป	Devarūpa*
เทวโลก	Devaloka
เทฺววาจิก	Dvevācika
เทศกาล	Desakāla
เทศน์มหาชาติ	Mahājātakadesanā*
เทศนา	Desanā
เทียน	Sitthadīpa
เทียนพรรษา	Vassadīpa, Vassikapadīpa
โทมนัส	Domanassa
โทษ	Dosa, Vajja, âdīnava
โทสะ	Dosa
โทสจริต	Dosacarita
โทสาคติ	Dosāgati
ไทยทาน	Deyyadāna
ไทยธรรม	Deyyadhamma
ธ
ธมกรก	Dhamakaraka
ธรณีสงฆ์ ดู ที่ธรณีสงฆ์.
ธรรม	Dhamma
ธรรมกถา	Dhammakathā
ธรรมกถึก	Dhammakathika
ธรรมขันธ์	Dhammakkhandha
ธรรมคุณ	Dhammaguṇa
ธรรมจริยา	Dhammacariyā
ธรรมจักร	Dhammacakka
ธรรมจักษุ	Dhammacakkhu
ธรรมจาริก	Dhammacārika
ธรรมเจดีย์	Dhammacetiya
ธรรมดา	Dhammatā
ธรรมทาน	Dhammadāna
ธรรมทูต	Dhammadūta*
ธรรมเทศนา	Dhammadesanā
ธรรมธร	Dhammadhara
ธรรมธาตุ	Dhammadhātu
ธรรมนิยาม	Dhammaniyāma
ธรรมบท	Dhammapada
ธรรมบรรยาย	Dhammapariyāya
ธรรมปฏิสัมภิทา ดู ธัมมปฏิสัมภิทา.
ธรรมยุต, ธรรมยุติกนิกาย	Dhammayuttika-nikā ya*
มหานิกาย.
ธรรมวาที	Dhammavādī
ธรรมวิจัย	Dhammavicaya
ธรรมวิชัย	Dhammavijaya
ธรรมวินัย	Dhammavinaya
ธรรมวิภาค	Dhammavibhāga
ธรรมสภา	Dhammasabhā
ธรรมสวนะ ดู ธัมมัสสวนะ.
ธรรมสากัจฉา	Dhammasākacchā
ธรรมเสนาบดี	Dhammasenāpati
ธรรมาธิปไตย	Dhammādhipateyya
ธรรมาธิษฐาน	Dhammādhiññhāna
ธรรมานุธรรมปฏิบัติ, ธัมมานุธัมมปฏิปัตติ	Dhammānudhammapañipatti
ธรรมารมณ์	Dhammārammaṇa
ธรรมาสน์	Dhammāsana
ธรรมีกถา	Dhammīkathā
ธัมม- ดู ธรรม-.
ธัมมกามตา	Dhammakāmatā
ธัมมจักกัปปวัตตนสูตร	Dhammacakkappavattanasutta
ธัมมเทสนามัย	Dhammadesanāmaya
ธัมมปฏิสัมภิทา	Dhammapañisambhidā
ธัมมสังคณี	Dhammasaṅgaṇi
ธัมมัญญุตา	Dhammaññutā
ธัมมัปปมาณิกา	Dhammappamāṇikā
ธัมมัสสวนะ	Dhammassavana
ธัมมัสสวนมัย	Dhammassavanamaya
ธัมมานุปัสสนา	Dhammānupassanā
ธัมมานุสติ	Dhammānussati
ธัมมาภิสมัย	Dhammābhisamaya
ธาตุ	Dhātu
ธาตุกถา	Dhātukathā
ธาตุกรรมฐาน ดู จตุธาตุววัตถาน.
ธาตุเจดีย์	Dhātucetiya
ธาตุมนสิการ ดู จตุธาตุววัตถาน.
ธาตุววัตถาน ดู จตุธาตุววัตถาน.
ธิติ	Dhiti
ธุดงค์	Dhutaṅga, Dhūtaṅga
ธุระ	Dhura
ธูป	Dhūpa
น
นมัสการ	Namakkāra
นรก	Naraka, Niraya
นิรยะ.
นวกภิกษุ	Navakabhikkhu
นวกรรม	Navakamma
นวนิต, นวนีตะ ดู เนยข้น
นักขัตฤกษ์	Nakkhattakīḷana
นักเทศก์ ดู ธรรมกถึก.
นักธรรม	Dhammika*
นักบวช	Pabbajita
นักพรต	Yati, Vatavantu
นักสวด	Dhammagāyaka*
นั่งขัดสมาธิ ดู ขัดสมาธิ.
นั่งคุกเข่า ดู คุกเข่า.
นั่งพับเพียบ ดู พับเพียบ.
นัจจคีตวาทิตวิสูกทัสสนะ	Naccagītavāditavisūkadassana
นัตถิกทิฏฐิ	Natthikadiññhi
นัตถิกวาท ก็ว่า.
นาค	Nāga
นาม	Nāma
นามรูป	Nāmarūpa
นาสนะ, นาสนา	Nāsana, ~nā
นํ้ ามนต์	Parittodaka*
นิกเขปบท	Nikkhepapada
นิกาย	Nikāya
นิครนถ์	Nigaṇñha
นิคหกรรม	Niggahakamma
นิจศีล	Niccasīla
นิตยภัต	Niccabhatta
นิทเทส	Niddesa
นิทาน	Nidāna
นินทา	Nindā
นิพพาน	Nibbāna
นิพพิทา	Nibbidā
นิมนต์, การ	Nimantana
นิมมานรดี	Nimmānarati
นิมิต, นิมิตต์	Nimitta
นิยสกรรม	Niyasakamma, Niyassa~
นิยาม	Niyāma
นิรยะ	Niraya
นิรุตติปฏิสัมภิทา	Niruttipañisambhidā
นิโรธ	Nirodha
นิวรณ์	Nīvaraṇa
นิวาต	Nivāta
นิสสยกรรม ดู นิยสกรรม.
นิสสรณวิมุตติ	Nissaraṇavimutti
นิสสัคคิยปาจิตตีย์	Nissaggiyapācittiya
นิสสัย	Nissaya
นิสัย	Nissaya
นิสัยมุตก์	Nissayamuttaka
เนกขัมมะ	Nekkhamma
เนกขัมมวิตก	Nekkhammavitakka
เนยข้น	Navanīta
เนยยะ	Neyya
เนยใส	Sappi
เนวสัญญานาสัญญายตนะ	Nevasaññānāsaññāyatana
บ
บรมธาตุ, พระ	Dhātu
บรรพชา	Pabbajjā
บรรพชิต	Pabbajita
บรรลุ	Pāpuṇāti; Sacchikaroti; Abhisameti
บริกรรม	Parikamma
บริขาร	Parikkhāra
บริจาค	Pariccāga
บริโภคเจดีย์	Paribhogacetiya
บริวาร	Parivāra
บริเวณวัด	âvāsapariveṇa
บริษัท	Parisā
บวช, การ	Pabbajjā, upasampadā
บังสุกุล	Paṁsukūla
บัณเฑาะก์	Paṇóaka
บัณเฑาะว์	Paṇóava
บัลลังก์	Pallaṅka
บาตร	Patta
บาป	Pāpa
บารมี	Pāramī
บาลี	Pāli
บำเพ็ญ	Pūreti, Bhāveti
บิณฑบาต	Piṇóapāta
บุคคลาธิษฐาน	Puggalādhiññhāna
บุญ	Puñña
บุญกิริยาวัตถุ	Puññakiriyāvatthu
บุถุชน ดู ปุถุชน.
บุพกรณ์	Pubbakaraṇa
บุพกรรม	Pubbakamma
บุพการี	Pubbakārī
บุพกิจ	Pubbakicca
บุพนิมิต	Pubbanimitta
บุพเปตพลี	Pubbapetabali
บุพเพนิวาสานุสติญาณ ดู ปุพเพ-.
บุพเพสันนิวาส	Pubbesannivāsa
บูชา	Pūjā
เบญจขันธ์	Pañcakkhandha
เบญจธรรม	Pañcadhamma
เบญจวัคคีย์	Pañcavaggiya
เบญจศีล	Pañcasīla
เบญจางคประดิษฐ์	Pañcappatiññhitena vandana
โบสถ์	Uposathagga, Uposathāgāra
ใบสีมา	Sīmānimittūparisilāpañña
ป
ปกรณ์	Pakaraṇa
ปฏิกูลสัญญา	Pañikūlasaññā
ปฏิคาหก	Pañiggāhaka
ปฏิฆะ	Pañigha
ปฏิจจสมุปบาท	Pañiccasamuppāda
ปฏิญญาตกรณะ	Pañiññātakaraṇa
ปฏิบัติ	Pañipatti
ปฏิปทา	Pañipadā
ปฏิปทาญาณทัสสนวิสุทธิ	Pañipadāñāṇadassanavisuddhi
ปฏิปัสสัทธิวิมุตติ	Pañipassaddhivimutti
ปฏิภาคนิมิตต์	Pañibhāganimitta
ปฏิภาณ	Pañibhāṇa
ปฏิภาณปฏิสัมภิทา	Pañibhāṇa-pañisambhidā
ปฏิมา	Pañimā
ปฏิรูปเทสวาสะ	Pañirūpadesavāsa
ปฏิโลม	Pañiloma
ปฏิเวธ	Pañivedha
ปฏิสนธิ	Pañisandhi
ปฏิสนธิขณะ	Pañisandhikkhaṇa
ปฏิสนธิวิญญาณ	Pañisandhiviññāṇa
ปฏิสวะ	Pañissava
ปฏิสังขรณ์	Pañisaṅkharaṇa
ปฏิสันถาร	Pañisanthāra
ปฏิสัมภิทา	Pañisambhidā
ปฏิสัมภิทามรรค	Pañisambhidāmagga
ปฏิสารณียกรรม	Pañisāraṇīyakamma
ปฐมฌาน	Pañhamajjhāna
ปฐมเทศนา	Pañhamadesanā
ปฐมยาม	Pañhamayāma
ปฐมสาวก	Pañhamasāvaka
ปฐวีธาตุ	Pañhavīdhātu
ปณิธาน	Paṇidhāna
ปทัฏฐาน	Padaññhāna
ปธาน	Padhāna
ปปัญจะ(Papañca) diversification; diffuseness;  multiplicity; proliferation.
ปมาทะ, ความประมาท	Pamāda
ปรจิตตวิชานน์ ดู เจโตปริยญาณ.
ปรทารกรรม	Paradārakamma
ปรนิมมิตวสวัตดี	Paranimmitavasavattī
ปรมัตถ์, ปรมัตถธรรม	Paramattha
ปรมัตถสัจจะ	Paramatthasacca
ปรโลก	Paraloka
ปรวาที	Paravādī
ประคต	Kāyabandhana
ประเคน	Sakkaccaṁ sahatthā deti
ประชุมเพลิง	Citakālimpana, Sarīrajjhāpana
ประทักษิณ	Padakkhiṇā
ประนมมือ ดู พนมมือ.
ประพรม	Abbhukkirati, Siñcati
ประมาท ดู ปมาทะ.
ปรางค์ ดู พระปรางค์.
ปราโมทย์	Pāmojja
ปริจจาคะ	Pariccāga
ปริเฉท	Pariccheda
ปริญญา	Pariññā
ปริญเญยยธรรม	Pariññeyyadhamma
ปริตร	Paritta
ปริเทวะ	Parideva
ปรินิพพาน	Parinibbāna
ปริพาชก	Paribbājaka
ปริยัติ	Pariyatti
ปริวาร	Parivāra
ปริวาส	Parivāsa
ปริสัญญุตา	Parisaññutā
ปลงอาบัติ	âpattidesanā
ปลงอายุสังขาร	âyusaṅkhāra-vossajjana
ปลาสะ	Palāsa
ปลิโพธ	Palibodha
ปวารณา	Pavāraṇā
ปสาทะ	Pasāda
ปหาตัพพธรรม	Pahātabbadhamma
ปหานะ	Pahāna
ปหานปธาน	Pahānapadhāna
ปักษ์	Pakkha
ปัจจยาการ	Paccayākāra
ปัจจเวกขณ์	Paccavekkhaṇa
ปัจจันตประเทศ	Paccantadesa
ปัจจัย	Paccaya
ปัจจัยสันนิสิตศีล	Paccayasannissitasīla
ปัจจุคมน์	Paccuggamana
ปัจจุทธรณ์	Paccuddharaṇa
ปัจจุปัฏฐาน	Paccupaññhāna
ปัจเจกพุทธะ	Paccekabuddha
ปัจฉิมพรรษา	Pacchimikā
ปัจฉาภัต	Pacchābhatta
ปัจฉาสมณะ	Pacchāsamaṇa
ปัจฉิมชาติ	Pacchimajāti
ปัจฉิมยาม	Pacchimayāma
ปัจฉิมวาจา	Pacchimavācā
ปัจฉิมโอวาท	Pacchimaovāda
ปัญจ- ดู เบญจ-.
ปัญจทวาร	Pañcadvāra
ปัญญา	Paññā
ปัญญาจักษุ	Paññācakkhu
ปัญญาวิมุตติ	Paññāvimutti
ปัญญาสัมปทา	Paññāsampadā
ปัญญาสิกขา ดู อธิปัญญาสิกขา.
ปัญหา	Pañhā
ปัฏฐาน	Paññhāna
ปัณณัตติวัชชะ	Paṇṇattivajja
ปัตตานุโมทนา	Pattānumodanā
ปัตตานุโมทนามัย	Pattānumodanāmaya
ปัตติทาน	Pattidāna
ปัตติทานมัย	Pattidānamaya
ปัพพัชชา ดู บรรพชา.
ปัพพาชนียกรรม	Pabbājanīyakamma
ปัสสัทธิ 	Passaddhi
ปัสสาสะ	Passāsa
ปาจิตตีย์	Pācittiya
ปาฏิเทสนียะ	Pāñidesanīya
ปาฏิโมกข์, ปาติโมกข์	Pāñmokkha, Pātimokkha
“the Fundamental Precepts”; the fundamental  rules of the Order; the 227 disciplinary rules  binding on Bhikkhus; a collection of the  fundamental precepts of the Order recited every  fortnight; fortnightly recitation of the fundamental  precepts; Disciplinary Code.
ปาฏิโมกขสังวรศีล, ปาติโมกข~	Pāñimokkhasaṁvarasīla
ปาฏิหาริย์	Pāñihāriya
ปาณาติบาต	Pāṇātipāta
ปาพจน์	Pāvacana
ปาโมชช์ ดู ปราโมทย์.
ปาราชิก	Pārājika
ปาริสุทธิศีล	Pārisuddhisīla
ปิฎก	Piñaka
ปิดทอง	Suvaṇṇālepa
ปิตติวิสัย, เปตติวิสัย	Pittivisaya, Pettivisaya
ปิตุฆาต	Pitughāta
ปินโต	Bhattahārikā*
ปิยวาจา	Piyavācā
ปิสุณวาจา	Pisuṇavācā
ปีติ	Pīti
ปุคคลบัญญัติ	Puggalapaññatti
ปุคคลัญญุตา	Puggalaññutā
ปุคคลาธิษฐาน ดู บุคคลาธิษฐาน.
ปุจฉาวิสัชชนา	Pucchāvissajjanā
ปุถุชน	Puthujjana
ปุพพ- ดู บุพพ-.
ปุพเพกตปุญญตา	Pubbekatapuññatā
ปุพเพนิวาสานุสติญาณ	Pubbenivāsānussatiñāṇa
ปุริมพรรษา	Purimikā
ปูชนียบุคคล	Pūjanīyapuggala
ปูชนียวัตถุ	Pūjanīyavatthu*
ปูชนียสถาน	Pūjanīyaññhāna*
ปูชา ดู บูชา.
ปูรณมี	Puṇṇamī
เปตวัตถุ	Petavatthu
เปยยวัชชะ	Peyyavajja
เปรต	Peta
เปรียญ	Pariññū*, Pāliññū*
เปสุญวาท ดู ปิสุณวาจา.
ผ
ผรณาปีติ	Pharaṇāpīti
ผรุสวาจา	Pharusavācā
ผล	Phala
ผัสสะ	Phassa
ผ้ากราบ	Abhivādanacela*
ผาณิต	Phāṇita
ผ้าป่า	Paṁsukūla-cīvara, Assāmika-vattha
“Forest Robe”;	probably, ผ้าป่าช้า
ผ้าอาบ	Udakasāñikā
ผ้าอาบนํ้ าฝน	Vassikasāñikā
ผูกสีมา	Sīmāsammati
เผดียง	Nimanteti
เผยแผ่	Pakāsana, Vipulakaraṇa
แผ่เมตตา	Mettāya pharaṇā
แผ่ส่วนกุศล ดู ปัตติทาน, อุทิศกุศล.
โผฏฐัพพะ	Phoññhabba
ฝ
ฝังลูกนิมิต	Sīmānimittanidhāna
ฝาบาตร	Pattapidhāna
พ
พนมมือ	Añjaliṁ karoti
พยากรณ์	Vyākaraṇa
พยาธิ	Byādhi
พยาบาท	Byāpāda
พยายาม, ความ	Vāyāma
พร	Vara
พรต	Vata
พรมนํ้ ามนต์	Parittodaka-abbhukkiraṇa*; ~-  siñcana*
พรรษา	Vassa
พรหม	Brahma
พรหมจรรย์	Brahmacariya
พรหมจารี	Brahmacārī
พรหมทัณฑ์	Brahmadaṇóa
พรหมโลก	Brahmaloka
พรหมวิหาร	Brahmavihāra
พระ- ตัด “พระ” ออกแล้วดูในลำดับของคำนั้นๆ.
พระ	Bhikkhu, Pabbajita
พระครู	Garuññhāniyabhikkhu*
พระเครื่อง	Khuddakabuddhapañibimba*
พระธรรม	Dhamma
พระนอน	Sīhaseyyākappakabuddhapañimā*,  Sayānapañimā*
พระบรมศาสดา	Satthu
พระบูชา	Patiññhānabuddhapañimā*
พระประธาน	Padhānabuddhapañimā*
พระปรางค์	Thūpa
พระผู้มีพระภาค	Bhagavā
พระพุทธเจ้า	Buddha
พระพุทธบาท	Buddhapāda
พระพุทธปฏิมา	Buddhapañimā
พระพุทธรูป	Buddharūpa
พระพุทธศาสนา	Buddhasāsana
พระสงฆ์	Saṅgha
พระไสยาสน์ ดู พระนอน.
พราหมณ์	Brāhmaṇa
พละ	Bala
พลี	Bali
พหุลกรรม	Bahulakamma
พหูสูต	Bahussuta
พัดยศ	Cittavījanī, òhānantaravījanī
พัทธสีมา	Baddhasīmā
พับเพียบ	Aóóhapallaṅkanisajjā
พาล	Bāla
พาหุสัจจะ	Bāhusacca
พิธี	Vidhāna
พิธีกร	Vidhikara*
พิธีกรรม	Pūjāvidhi, Cārittaniyama*
พิธีหลวง ดู ราชพิธี.
พินทุ, พินทุกัป ดู กัปปพินทุ.
พีชนิยาม	Bījaniyāma
พุทธะ	Buddha
พุทธกาล	Buddhakāla
พุทธกิจ	Buddhakicca
พุทธคุณ	Buddhaguṇa
พุทธจริยา	Buddhacariyā
พุทธจักร	Buddhacakka
พุทธบริษัท	Buddhaparisā
พุทธบาท	Buddhapāda
พุทธปฏิมา ดู พระพุทธปฏิมา.
พุทธประวัติ	Buddhapavatti*
พุทธพจน์	Buddhavacana
พุทธภาษิต	Buddhabhāsita
พุทธมามกะ	Buddhamāmaka
พุทธรูป ดู พระพุทธรูป.
พุทธวงศ์	Buddhavaṁsa
พุทธศักราช	Buddhasaka*
พุทธศาสนา ดู พระพุทธศาสนา.
พุทธศาสนิกชน	Buddhamāmaka
พุทธันดร	Buddhantara
พุทธานุสติ	Buddhānussati
พุทธาวาส	Buddhāvāsa*
พุทธิจริต	Buddhicarita
เพล	Pacchimabhattakāla*
แพศย์	Vessa
โพชฌงค์	Bojjhaṅga
โพธิ์	ต้นไม้
โพธิญาณ	Bodhiñāṇa
โพธิปักขิยธรรม 	Bodhipakkhiya-dhamma
โพธิสัตว์, พระ	Bodhisatta
ฟ
ฟันเฟอน	muññhassati
ฟันเฟอน, ความ	sammosa
ฟุงซ่าน, ความ	uddhacca
ภ
ภควา ดู พระผู้มีพระภาค.
ภพ	Bhava
ภยาคติ	Bhayāgati
ภวตัณหา	Bhavataṇhā
ภวังค์	Bhavaṅga
ภังคะ	Bhaṅga
ภัณฑาคาริก	Bhaṇóāgārika
ภัณฑูกรรม	Bhaṇóūkamma
ภัต	Bhatta
ภัตกิจ	Bhattakicca
ภัตตุเทศก์	Bhattuddesaka
ภัย	Bhaya
ภาวะ	Bhāva
ภาวนา	Bhāvanā
ภาวนาปธาน	Bhāvanāpadhāna
ภาวนามยปัญญา	Bhāvanāmayapaññā
ภาวนามัย	Bhāvanāmaya
ภาเวตัพพธรรม	Bhāvetabbadhamma
ภาษิต	Bhāsita
ภิกขา	Bhikkhā
ภิกขาจาร	Bhikkhācāra
ภิกษุ	Bhikkhu
ภิกษุณี	Bhikkhunī
ภูต	Bhūta
ภูมิ	Bhūmi
เภสัช	Bhesajja
โภคะ	Bhoga
โภชนะ	Bhojana
โภชนียะ	Bhojanīya
โภชเนมัตตัญญุตา	Bhojanemattaññutā
ม
มงคล	Maṅgala
มณฑป	Maṇóapa
มทะ	Mada
มนต์, มนตร์	Manta
มนะ, มโน	Mana
มนสิการ	Manasikāra
มนุษย์	Manussa
มนุษยธรรม	Manussadhamma
มนุษยโลก	Manussaloka
มโนกรรม	Manokamma
มโนทวาร	Manodvāra
มโนทุจริต	Manoduccarita
มโนธาตุ	Manodhātu
มโนมยิทธิ	Manomayiddhi
มโนวิญญาณ	Manoviññāṇa
มโนวิญญาณธาตุ	Manoviññāṇadhātu
มโนสังขาร ดู จิตตสังขาร.
มโนสุจริต	Manosucarita
มมังการ	Mamaṅkāra
มรณะ	Maraṇa
มรณภาพ	Maraṇabhāva*
มรณสติ	Maraṇasati
มรรค	Magga
มรรคนายก	Magganāyaka*
มละ	Mala
มหา	Mahā*
มหาชาติ	Mahājātaka
มหาเถรสมาคม	Mahātherasamāgama*
มหานิกาย	Mahānikāya*
“Great Sect”; Greater Sub-Order	of the Thai  Monkhood
ยุต.
มหาบุรุษ	Mahāpurisa
มหาปุริสลักษณะ	Mahāpurisalakkhaṇa
มหาภิเนษกรมณ์	Mahābhinikkhamana
มหาภูตรูป	Mahābhūtarūpa
มหายาน	Mahāyāna
มักขะ	Makkha
มักน้อย, ความ ดู อัปปิจฉตา.
มัคคะ ดู มรรค.
มังสวิรัติ	Maṁsavirati*
มัจจุ	Maccu
มัจจุราช	Maccurāja
มัจฉริยะ	Macchariya
มัชชะ	Majja
มัชฌิมะ	Majjhima
มัชฌิมนิกาย	Majjhimanikāya
มัชฌิมประเทศ ดู มัธยมประเทศ.
มัชฌิมยาม	Majjhimayāma
มัชฌิมาปฏิปทา	Majjhimā pañipadā
มัตตัญญุตา	Mattaññutā
มัททวะ	Maddava
มัธยมประเทศ	Majjhimadesa
มาฆบูชา	Māghapūjā
มาตาปิตุอุปัฏฐาน	Mātāpituupaññhāna
มาติกา	Mātikā
มาตุคาม	Mātugāma
มาตุฆาต	Mātughāta
มานะ	Māna
มานัต	Mānatta
มายา	Māyā
มาร	Māra
มิจฉาทิฏฐิ	Micchādiññhi
มิตรปฏิรูปก์	Mittapañirūpaka
มิทธะ	Middha
มุขบาฐ; มุขปาฐะ	Mukhapāñha
มุทิตา	Muditā
มุทิตาจิต, การแสดง	Muditākamma*
มุสาวาท	Musāvāda
มูลกรรมฐาน	Mūla-kammaññhāna
มูลบัญญัติ	Paññatti, Mūlapaññatti
เมตตา	Mettā
เมถุนธรรม	Methunadhamma
เมรุ ดู จิตกาธาน.
เมาลี; โมลี	Moli
โมกขธรรม	Mokkhadhamma
โมกษะ	Mokkha
โมหะ	Moha
โมหจริต	Mohacarita
โมหาคติ	Mohāgati
ย
ยกช่อฟา, พิธี	Kaṇṇikāropana*
ยถาภูตญาณทัศนะ	Yathābhūtañāṇadassana
ยม	Yama
ยมก	Yamaka
ยมกปาฏิหาริย์	Yamakapāñihāriya
ยศ	Yasa
ยักษ์	Yakkha
ยัญ	Yañña
ย่าม	Thavikā
ยามา	Yāmā
เยภุยยสิกา	Yebhuyyasikā
โยคะ	Yoga
โยคาวจร	Yogāvacara
โยคี	Yogī
โยชน์	Yojana
โยนิ	Yoni
โยนิโสมนสิการ	Yonisomanasikāra
โยม	Posī
ร
รส	Rasa
ระเบียง [โบสถ์วิหาร]	Mañha, Samanta-paghaṇa
รัตนตรัย	Ratanattaya
รัตตัญญู	Rattaññū
ราคะ	Rāga
ราคจริต	Rāgacarita
ราชพลี	Rājabali
ราชพิธี	Rājavidhi*, Rājapūjāvidhi*
ราชาคณะ, พระ	Rājāgaṇayati, Cūḷasaṅgharājā*
ริษยา ดู อิสสา.
รูป	Rūpa
รูปฌาน	Rūpajhāna
รูปราคะ	Rūparāga
รูปโลก	Rūpaloka
รูปารมณ์	Rūpārammaṇa
รูปาวจรภูมิ	Rūpāvacarabhūmi
เรี่ยไร, การ	Samantayācanā*
เรือนแก้ว	ratanaghara*
ฤ
ฤทธิ์ ดู อิทธิ.
ฤษี	Isi
ล
ลอยกระทง	Puñaplāvana*
ลักษณะ	Lakkhaṇa
ลัทธิ	Laddhi
ลาภ	Lābha
ลาสิกขา	Sikkhaṁ paccakkhāti
ลูกนิมิต	Sīmā-nimitta, Nimitta
ลูขัปปมาณิกา	Lūkhappamāṇikā
โลก	Loka
โลกธรรม	Lokadhamma
โลกธาตุ	Lokadhātu
โลกบาล ดู จาตุมหาราช.
โลกวัชชะ	Lokavajja
โลกาธิปไตย	Lokādhipateyya
โลกิยะ	Lokiya
โลกุตตระ	Lokuttara
โลกุตตรธรรม	Lokuttaradhamma
โลกุตตรภูมิ	Lokuttarabhūmi
โลภะ	Lobha
โลหิตุปบาท	Lohituppāda
ว
วจีกรรม	Vacīkamma
วจีทวาร	Vacīdvāra
วจีทุจริต	Vacīduccarita
วจีวิญญัติ	Vacīviññatti
วจีสังขาร	Vacīsaṅkhāra
วจีสุจริต	Vacīsucarita
วรรค	Vagga
วรรณะ	Vaṇṇa
วัจจกุฎี	Vaccakuñī
วัฏฏะ	Vañña
วัณณะ ดู วรรณะ.
วัด	Vihāra, ârāma
วัดร้าง	Suññavihāra*
วัดราษฎร์	Gāmikavihāra*
วัดหลวง	Rājavaravihāra*, Rājāvāsa*
วัตถุกาม	Vatthukāma
วัตถุมงคล	Maṅgalavatthu*
วัตร	Vatta
วันโกน	Kesoropaṇadivasa*
วันเข้าพรรษา	Vassūpanāyikādivasa
วันปวารณา	Pavāraṇādivasa
วันพระ	Uposathadivasa
วันเพ็ญ	Puṇṇamīdivasa
วันออกพรรษา	Pavāraṇādivasa
วันอุโบสถ	Uposathadivasa
วัย	Vaya
วัสสูปนายิกา ดู วันเข้าพรรษา.
วาจา	Vācā
วาทะ	Vāda
วายามะ	Vāyāma
วาโยธาตุ	Vāyodhātu
วิกขัมภนวิมุตติ	Vikkhambhanavimutti
วิกัป	Vikappa
วิกาล	Vikāla
วิจัย	Vicaya
วิจาร	Vicāra
วิจิกิจฉา	Vicikicchā
วิชชา	Vijjā
วิญญัติ	Viññatti
วิญญาณ	Viññāṇa
วิญญาณัญจายตนะ	Viññāṇañcāyatana
วิญญูชน	Viññū
วิตก	Vitakka
วิตกจริต	Vitakkacarita
วิถีจิต	Vīthicitta
วินัย	Vinaya
วินัยธร	Vinayadhara
คณะวินัยธร.
วินัยปิฎก	Vinayapiñaka
วินิบาต	Vinipāta
วิบัติ	Vipatti
วิบาก	Vipāka
วิปฏิสาร	Vippañisāra
วิปริณาม	Vipariṇāma
วิปลาส	Vipallāsa
วิปัสสนา	Vipassanā
วิปัสสนากรรมฐาน ดู วิปัสสนาภาวนา.
วิปัสสนาธุระ	Vipassanādhura
วิปัสสนาภาวนา	Vipassanā-bhāvanā
วิปากจิต	Vipākacitta
วิภวตัณหา	Vibhavataṇhā
วิภังค์	Vibhaṅga
วิมังสา	Vīmaṁsā
วิมาน	Vimāna
วิมานวัตถุ	Vimānavatthu
วิมุตติ	Vimutti
วิมุตติสุข	Vimuttisukha
วิโมกข์	Vimokkha
วิรัติ	Virati
วิราคะ	Virāga
วิริยะ	Viriya; Vīriya
วิริยารัมภะ	Viriyārambha
วิวัฏฏ์	Vivañña
วิวาทาธิกรณ์	Vivādādhikaraṇa
วิเวก	Viveka
วิสังขาร ดู อสังขตธรรม.
วิสัชนา	Visajjanā
วิสัย	Visaya
วิสาขบูชา	Visākhapūjā
วิสุงคามสีมา	Visuṁgāmasīmā
วิสุทธิ	Visuddhi
วิหาร	Vihāra
วิหารคด	Mañha; Samantapaghaṇa
วิหิงสาวิตก	Vihiṁsāvitakka
เวจกุฎี ดู ถาน.
เวทนา	Vedanā
เวทนานุปัสสนา	Vedanānupassanā
เวไนย	Veneyya
เวยยาวัจจะ	Veyyāvacca
เวยยาวัจจมัย	Veyyāvaccamaya
เวร	Vera
เวสสะ ดู แพศย์.
เวสารัชชะ	Vesārajja
เวียนเทียน ดู ประทักษิณ.
ไวยาวัจกร	Veyyāvaccakara
ศ
ศรัทธา ดู สัทธา.
ศรัทธาไทย	Saddhādeyya
ศาลพระภูมิ	Bhummadevaññhāna*
ศาลา	Sālā
ศาลาการเปรียญ ดู การเปรียญ.
ศาสดา	Satthu
ศาสดา, พระบรม	Satthu
ศาสดาพยากรณ์	Anāgatavattu*
ศาสนสมบัติ	Sāsanasampatti*
ศาสนา1	Sāsana
ศาสนา2	Samaya, Diññhi, Pāsaṇóa
ศาสนาจารย์	Sāsanācariya
อนุศาสนาจารย์.
ศาสนิก	Sāsanika
ศิษย์วัด	ârāmika, Kappiyakāraka, Bhikkhusissa
ศีล	Sīla; Sikkhāpada
ศีลธรรม	Sīla; Sucarita; âcāra
ศีลาจารวัตร	Sīlācāravatta*
ศูทร	Sudda
โศก	Soka
ส
สกทาคามิผล	Sakadāgāmiphala
สกทาคามิมรรค	Sakadāgāmimagga
สกทาคามี, พระ	Sakadāgāmī
สกลมหาสังฆปริณายก	Sakalamahāsaṅghapariṇāyaka
พระสังฆราช	Saṅgharāja
สกวาที	Sakavādī
สงกรานต์	Mahāsaṅkanti
สงเคราะห์	Saṅgaha
สงฆ์	Saṅgha
สงสาร	Saṁsāra, Saṁsāracakka
สติ	Sati
สติปัฏฐาน	Satipaññhāna
สติวินัย	Sativinaya
สเตกิจฉา	Satekicchā
สถูป	Thūpa
สทารสันโดษ	Sadārasantosa
สนทนาธรรม ดู ธรรมสากัจฉา.
สบง	Antaravāsaka
สพรหมจารี	Sabrahmacārī
สภาวะ	Sabhāva
สภาวธรรม	Sabhāvadhamma
สมชีวิตา	Samajīvitā
สมณะ	Samaṇa
สมณธรรม	Samaṇadhamma
สมณพราหมณ์	Samaṇa-brāhmaṇa
สมณศักดิ์	Samaṇasatti*
สมณสัญญา	Samaṇasaññā
สมณสารูป	Samaṇasāruppa
สมณุเทศ	Samaṇuddesa
สมเด็จ	Upasaṅgharāja*
สมถะ	Samatha
สมถกัมมัฏฐาน, ~กรรมฐาน ดู สมถภาวนา.
สมถภาวนา	Samathabhāvanā
สมบัติ	Sampatti
สมภาร ดู เจ้าอาวาส.
สมโภช ดู ฉลอง.
สมมติ, สมมุติ	Sammati; Sammuti
สมมติสงฆ์, สมมุติสงฆ์	Sammatisaṅgha;  Sammutisaṅgha
สมมติสัจจะ, สมมุติสัจจะ	Sammatisacca;  Sammutisacca
สมาทาน	Samādāna
สมาธิ	Samādhi
สมานัตตตา	Samānattatā
สมาบัติ	Samāpatti
สมุจเฉทวิมุตติ	Samucchedavimutti
สมุฏฐาน	Samuññhāna
สมุทัย	Samudaya
สยัมภู, สยมภู	Sayambhū
สรงนํ้ า	Nhāyati
สรณะ	Saraṇa
สรณคมน์, สรณาคมน์	Saraṇagamana, ~ṇā gamana
สรภัญญะ	Sarabhañña
สรรเสริญ, ความ	Pasaṁsā
สรีระ	Sarīra
สลากภัต	Salākabhatta
สวดปาฏิโมกข์, การ	Pāñimokkhuddesa
สวดพระอภิธรรม	Abhidhammabhaṇana*
สวดมนต์, การ [ทั่ว ๆ ไป]	âyācanā
สวดมนต์, การ [ในพุทธศาสนา]	Sajjhāya, Uddesa, Padabhāṇa, ~gāyana, ~bhaṇana, Parittakaraṇa
สวรรค์	Sagga
สหธรรมิก	Sahadhammika
สฬายตนะ	Saḷāyatana
สอุปาทิเสสนิพพาน	Saupādisesa-nibbāna
สักกายทิฏฐิ	Sakkāyadiññhi
สักการะ	Sakkāra
สัคคะ ดู สวรรค์.
สังขตธรรม	Saṅkhatadhamma
สังขาร	Saṅkhāra
สังคณี ดู ธัมมสังคณี.
สังคหวัตถุ	Saṅgahavatthu
สังคายนา, สังคีติ	Saṅgīti
สังฆกรรม	Saṅghakamma
สังฆคุณ	Saṅghaguṇa
สังฆทาน	Saṅghadāna
สังฆนายก	Saṅghanāyaka*
สังฆเภท	Saṅghabheda
สังฆมณฑล	Saṅghamaṇóala
สังฆมนตรี Eccl. Minister. ดู คณะสังฆมนตรี.
สังฆราช, สมเด็จพระ	Saṅgharāja
สังฆสภา	Saṅghasabhā
สังฆาฏิ	Saṅghāñi
สังฆาทิเสส	Saṅghādisesa
สังฆาธิการ	Saṅghādhikāra*
สังฆานุสติ	Saṅghānussati
สังฆาวาส	Saṅghāvāsa*
สังยุตตนิกาย	Saṁyuttanikāya
สังโยชน์	Saṁyojana
สังวร	Saṁvara
สังวรปธาน	Saṁvarapadhāna
สังวาส	Saṁvāsa
สังเวคะ	Saṁvega
สังเวชนียสถาน	Saṁvejanīyaññhāna
สังสารวัฏ ดู สงสาร.
สังเสทชะ	Saṁsedaja
สัจจะ	Sacca
สัจจธรรม	Sacca
สัจฉิกาตัพพธรรม	Sacchikātabbadhamma
สัญญมะ	Saññama, Saṁyama
สัญญา	Saññā
สัญญาบัตร	Saññāpañña*
สัญโญชน์ ดู สังโยชน์.
สัตตาวาส	Sattāvāsa
สัตตาหกรณียะ	Sattāhakaraṇīya
สัตบุรุษ	Sappurisa
สัตว์	Satta
สัททารมณ์	Saddārammaṇa
สัทธรรม	Saddhamma
สัทธรรมปฏิรูปก์	Saddhammapañirūpaka
สัทธา	Saddhā
สัทธาจริต	Saddhācarita
สัทธาสัมปทา	Saddhāsampadā
สัทธิวิหาริก	Saddhivihārika
สันดาน ดู สันตานะ.
สันโดษ	Santuññhi, Santosa
สันตติ	Santati
สันตานะ	Santāna
สันติ	Santi
สันตุฏฐี ดู สันโดษ.
สัปปายะ	Sappāya
สัปปิ	Sappi
สัปปุริส ดู สัตบุรุษ.
สัปปุริสธรรม	Sappurisadhamma
สัพพัญญุตญาณ	Sabbaññutañāṇa
สัพพัญญู	Sabbaññū
สัมปชัญญะ	Sampajañña
สัมปทา	Sampadā
สัมปรายะ	Samparāya
สัมปรายภพ	Samparāya
สัมปรายิกัตถะ	Samparāyikattha
สัมผัปปลาปะ	Samphappalāpa
สัมผัส ดู ผัสสะ.
สัมพุทธะ	Sambuddha
สัมภเวสี	Sambhavesī
สัมมัปปธาน	Sammappadhāna
สัมมากัมมันตะ	Sammākammanta
สัมมาทิฏฐิ	Sammādiññhi
สัมมาวาจา	Sammāvācā
สัมมาวายามะ	Sammāvāyāma
สัมมาสังกัปปะ	Sammāsaṅkappa
สัมมาสติ	Sammāsati
สัมมาสมาธิ	Sammāsamādhi
สัมมาสัมพุทธะ	Sammāsambuddha
สัมมาอาชีวะ	Sammāājīva
สัมมุขาวินัย	Sammukhāvinaya
สัสสตทิฏฐิ	Sassatadiññhi
สากัจฉา	Sākacchā
สาชีพ	Sājīva
สาเฐยยะ, สาไถย	Sāñheyya
สาธยาย ดู สวดมนต์ [ในพุทธศาสนา].
สามเณร	Sāmaṇera
สามเณรี	Sāmaṇerī
สามัคคี	Sāmaggī
สามัญลักษณะ	Sāmaññalakkhaṇa
สามีจิกรรม	Sāmīcikamma
สายสิญจน์	Parittasutta*
สารัมภะ	Sārambha
สาราณียธรรม	Sārāṇīyadhamma
สารีริกธาตุ ดู ธาตุ.
สาวก	Sāvaka
สำนักสงฆ์	Saṅghanivāsa*, Saṅghaniketa*
สำรวม	Saṁvara
สิกขมานา	Sikkhamānā
สิกขา	Sikkhā
สิกขาบท	Sikkhāpada
สีมา	Sīmā
สีล	Sīla
สีลมัย	Sīlamaya
สีลวิสุทธิ	Sīlavisuddhi
สีลสัมปทา	Sīlasampadā
สีลสามัญญตา	Sīlasāmaññatā
สีลสิกขา ดู อธิศีลสิกขา.
สีลัพพตปรามาส	Sīlabbataparāmāsa
สีลัพพตุปาทาน	Sīlabbatupādāna
สีลานุสติ	Silānussati
สีหไสยา	Sīhaseyyā
สึก	Uppabbajati, Vibbhamati
สุกขวิปัสสก	Sukkhavipassaka
สุข	Sukha
สุคต	Sugata
สุคติ	Sugati
สุจริต	Sucarita
สุตะ	Suta
สุตตนิบาต	Suttanipāta
“Woven Cadences of Early Buddhists”; name  of the fifth division of the Khuddaka Nikāya.
สุตตันตปิฎก	Suttantapiñaka
สุตมยปัญญา	Sutamayapaññā
สุททะ ดู ศูทร.
สุทธาวาส	Suddhāvāsa
สุภาษิต	Subhāsita
สุราเมรยมัชชปมาทัฏฐาน	Surāmerayamajjapamādaññhāna
สุริยคติ	Suriyagati*
สูตร	Sutta; Suttanta
สูตร, พระ	Sutta; Suttapiñaka
เสขะ, พระ	Sekha; Sekkha
เสขิยวัตร	Sekhiyadhamma; Sekhiyavatta
เสนาสนะ	Senāsana
โสกะ ดู โศก.
โสดาบัน	Sotāpanna
โสดาปัตติผล	Sotāpattiphala
โสดาปัตติมรรค	Sotāpattimagga
โสตทวาร	Sotadvāra
โสตวิญญาณ	Sotaviññāṇa
โสมนัส	Somanassa
โสรัจจะ	Soracca
โสวจัสสตา	Sovacassatā
โสฬส	Soḷasa
ไสยา	Seyyā
ห
หงสบาท	Haṁsapāda
หนังสือสุทธิ	Suddhipañña*
หน้าตัก	Pallaṅkappamāṇa
หน้าบัน	Gahasikhara
หอฉัน	Bhattagga
หอไตร	Tipiñakālaya*; Potthakāgāra*; Ganthālaya*
หอระฆัง	Gaṇóighara
หอสวดมนต์	Sajjhāyanasālā*
หทัยวัตถุ	Hadayavatthu
หลุดพ้น, ความ ดู วิมุตติ.
หสิตุปปาทจิต	Hasituppādacitta
หัตถบาส	Hatthapāsa
หิริ	Hiri
หีนยาน	Hīnayāna
เหตุ	Hetu
ไหว้	Vandana, Namassana
อ
อกตัญญู	Akataññū
อกรณียกิจ	Akaraṇīyakicca
อกาลมรณะ	Akālamaraṇa
อกิริยทิฏฐิ	Akiriyadiññhi
อกิริยวาท ก็ว่า.
อกุศล	Akusala
อกุศลกรรม	Akusalakamma
อกุศลกรรมบถ	Akusalakammapatha
อกุศลจิต	Akusalacitta
อกุศลมูล	Akusalamūla
อกุศลวิตก	Akusalavitakka
อคติ	Agati
อโคจร	Agocara
องค์	Aṅga
องค์การปกครอง	Saṅghapālanādhikāra*
องค์การเผยแผ่	Dhammapakāsanādhikāra*
องค์การศึกษา	Sāsanasikkhādhikāra*
องค์การสาธารณูปการ	Sādhāraṇakārādhikāra*
อจินไตย	Acinteyya
อดิเรกจีวร	Atirekacīvara
อดิเรกลาภ	Atirekalābha
อติถิพลี	Atithibali
อติมานะ	Atimāna
อเตกิจฉา	Atekicchā
อทินนาทาน	Adinnādāna
อทุกขมสุข	Adukkhamasukha
อโทสะ	Adosa
อธรรม	Adhamma
อธิกมาส	Adhikamāsa
อธิกรณ์	Adhikaraṇa
อธิกรณสมถะ	Adhikaraṇasamatha
อธิกวาร	Adhikavāra
อธิกสุรทิน	Adhikasuradina*
อธิจิตตสิกขา	Adhicittasikkhā
อธิปไตย	Adhipateyya
อธิปัญญาสิกขา	Adhipaññāsikkhā
อธิโมกข์	Adhimokkha
อธิศีลสิกขา	Adhisīlasikkhā
อธิษฐาน	Adhiññhāna
อนภิชฌา	Anabhijjhā
อนัตตตา	Anattatā
อนัตตา	Anattā
อนาคามิผล	Anāgāmiphala
อนาคามิมรรค	Anāgāmimagga
อนาคามี, พระ	Anāgāmī
อนาคาริก	Anāgārika
อนิจ	Anicca
อนิจจตา	Aniccatā
อนิฏฐารมณ์	Aniññhārammaṇa
อนิยต	Aniyata
อนุจร	Anucara
อนุฎีกา	Anuñīkā
อนุบัญญัติ	Anupaññatti
อนุปสัมบัน	Anupasampanna
อนุปาทินนก	Anupādinnaka
อนุปาทิเสสนิพพาน	Anupādisesa-nibbāna
อนุปุพพิกถา	Anupubbikathā
อนุพยัญชนะ	Anubyañjana
อนุโมทนา	Anumodanā
อนุรักขนาปธาน	Anurakkhanāpadhāna
อนุโลม	Anuloma
อนุวาทาธิกรณ์	Anuvādādhikaraṇa
อนุศาสน์	Anusāsana
อนุศาสนาจารย์	Anusāsanācariya
อนุสติ	Anussati
อนุสัย	Anusaya
อนุสาวนา	Anusāvanā
อนุสาวนาจารย์	Anusāvanācariya
อนุสาสนีปาฏิหาริย์	Anusāsanīpāñihāriya
อเนสนา	Anesanā
อบาย	Apāya
อบายภูมิ	Apāyabhūmi
อบายมุข	Apāyamukha
อปจายนะ	Apacāyana
อปจายนมัย	Apacāyanamaya
อปทาน	Apadāna
อปราปริยเวทนียกรรม	Aparāpariyavedanīyakamma
อปโลกน์	Apalokana
อปโลกนกรรม	Apalokanakamma
อพยาบาท	Abyāpāda
อภิชฌา	Abhijjhā
อภิญญา	Abhiññā
อภิธรรม	Abhidhamma
อภิธรรมปิฎก	Abhidhammapiñaka
อภิเนษกรมณ์ ดู มหาภิเนษกรมณ์.
อภิสมัย	Abhisamaya
อภิสมาจาร	Abhisamācāra
อภิสัมโพธิ	Abhisambodhi
อมตะ	Amata
อมูฬหวินัย	Amūḷhavinaya
อโมหะ	Amoha
อโยนิโสมนสิการ	Ayonisomanasikāra
อรรคสาวก ดู อัครสาวก.
อรรถ ดู อัตถะ.
อรรถกถา	Aññhakathā
อรหัตตผล	Arahattaphala
อรหัตตมรรค	Arahattamagga
อรหันต์, พระ	Arahanta
อรหันตฆาต	Arahantaghāta
อรัญวาสี	Araññavāsī
อริยทรัพย์	Ariyadhana
อริยบุคคล	Ariyapuggala
อริยผล	Ariyaphala
อริยมรรค	Ariyamagga
อริยสัจจ์	Ariyasacca
อรูปฌาน	Arūpajhāna
อรูปภพ ดู อรูปโลก.
อรูปราคะ	Arūparāga
อรูปโลก	Arūpaloka
อรูปาวจร	Arūpāvacara
อรูปาวจรภูมิ	Arūpāvacarabhūmi
อลัชชี	Alajjī
อโลภะ	Alobha
อวมงคล	Avamaṅgala
อวหาร	Avahāra
อวิชชา	Avijjā
อวิโรธนะ	Avirodhana
อวิหิงสา ดู อหิงสา.
อเวจี	Avīci
อสงไขย	Asaṅkheyya
อสทิสทาน	Asadisadāna
อสังขตธรรม	Asaṅkhatadhamma
อสุภะ	Asubha
อสุรกาย	Asurakāya
อเสขะ	Asekha
อหังการ	Ahaṁkāra
อหิงสา, อวิหิงสา	Ahiṁsā, Avihiṁsā
อเหตุกทิฏฐิ	Ahetukadiññhi
อโหสิกรรม	Ahosikamma
อักโกธะ	Akkodha
อัครสาวก	Aggasāvaka
อังคาร	Aṅgāra
อังคาส	Parivisana
อังคุตตรนิกาย	Aṅguttaranikāya
อังสะ	Aṁsa
อัจฉริยะ	Acchariya
อัญชลี ดู พนมมือ.
อัณฑชะ	Aṇóaja
อัตตกิลมถานุโยค	Attakilamathānuyoga
อัตตวาทุปาทาน	Attavādupādāna
อัตตสัมมาปณิธิ	Attasammāpaṇidhi
อัตตัญญุตา	Attaññutā
อัตตา	Attā
อัตตาธิปไตย	Attādhipateyya
อัตถะ	Attha
อัตถจริยา	Atthacariyā
อัตถปฏิสัมภิทา	Atthapañisambhidā
อัตถัญญุตา	Atthaññutā
อัตภาพ	Attabhāva
อันตคาหิกทิฏฐิ	Antagāhikadiññhi
อันตรวาสก	Antaravāsaka
อันตา	Antā
อันติมวัตถุ	Antimavatthu
อันเตวาสิก	Antevāsika
อัปปนาสมาธิ	Appanāsamādhi
อัปปมัญญา	Appamaññā
อัปปมาทะ	Appamāda
อัปปิจฉตา	Appicchatā
อัพโพหาริก	Abbohārika
อัพยากฤต	Abyākata; Avyākata
อัสสาทะ	Assāda
อัสสาสะ	Assāsa
อา–โอ
อากาส [ธาตุ]	âkāsa
อากาสานัญจายตนะ	âkāsānañcāyatana
อากิญจัญญายตนะ	âkiñcaññāyatana
อาคันตุกะ	âgantuka
อาฆาต	âghāta
อาจาระ	âcāra
อาจารย์	âcariya
อาจิณณกรรม	âciṇṇakamma
อาชชวะ honesty; integrity.
อาชีวก	âjīvaka
อาชีวปาริสุทธิศีล	âjīvapārisuddhisīla
อาตมัน	Attā; Sanskrit: âtman
อาทิกัมมิกะ	âdikammika
อาทิพรหมจรรย์	âdibrahmacariya
อาทีนพ, อาทีนวะ	âdīnava
อาเทสนาปาฏิหาริย์	âdesanāpāñihāriya
อานาปานสติ	ânāpānasati
อานิสงส์	ânisaṁsa
อาบัติ	âpatti
อาปัตตาธิกรณ์	âpattādhikaraṇa
อาโปธาตุ	âpodhātu
อามิส	âmisa
อามิสทาน	âmisadāna
อายตนะ	âyatana
ภายนอก: sense-objects and mind-object.
อายุ	âyu
อายุสังขาร	âyusaṅkhāra
อารมณ์	ârammaṇa
อารักขสัมปทา	ârakkhasampadā
อารามิก	ârāmika
อาสน์สงฆ์	Saṅghāsana*
อาสวะ	âsāva
อาสวักขยญาณ	âsavakkhayañāṇa
อาสันนกรรม	âsannakamma
อาสาฬหบูชา	âsāḷhapūjā
อาหาร	âhāra
อิจฉา	Icchā
อิติวุตตกะ	Itivuttaka
อิทธิ	Iddhi
อิทธิบาท	Iddhipāda
อิทธิปาฏิหาริย์	Iddhipāñihāriya
อิทธิวิธิ	Iddhividhi
อินทรีย์	Indriya
อินทรียสังวรศีล	Indriyasaṁvarasīla
อิริยาบถ	Iriyāpatha
อิสสา	Issā
อุกเขปนียกรรม	Ukkhepanīyakamma
อุคคหนิมิตต์	Uggahanimitta
อุจเฉททิฏฐิ	Ucchedadiññhi
อุฏฐานสัมปทา	Uññhānasampadā
อุตราสงค์	Uttarāsaṅga
อุตริมนุสธรรม	Uttarimanussadhamma
อุตุนิยาม	Utuniyāma
อุทเทสิกเจดีย์	Uddesikacetiya
อุทธัจจะ	Uddhacca
อุทธัจจกุกกุจจะ	Uddhaccakukkucca
อุทาน	Udāna
อุทิศกุศล, การ	Pattidāna, Dakkhiṇādisana
อุบาย	Upāya
อุบาสก	Upāsaka
อุบาสิกา	Upāsikā
อุเบกขา	Upekkhā
อุโบสถ	Uposatha
อุโบสถศีล	Uposathasīla
อุปกิเลส	Upakkilesa
อุปฆาตกกรรม	Upaghātakakamma
อุปจาร	Upacāra
อุปจารสมาธิ	Upacārasamādhi
อุปฐาก, อุปัฏฐาก	Upaññhāka
อุปนาหะ	Upanāha
อุปปัชชเวทนียกรรม	Upapajjavedanīyakamma
อุปปาทะ	Uppāda
อุปปีฬกกรรม	Upapīḷakakamma
อุปมา	Upamā
อุปสมบท	Upasampadā
อุปสัมบัน	Upasampanna
อุปัชฌาย์	Upajjhāya
อุปัตถัมภกกรรม	Upatthambhakakamma
อุปาทาน	Upādāna
อุปาทานขันธ์	Upādānakkhandha
อุปาทายรูป	Upādāyarūpa
อุปาทินนกะ	Upādinnaka
อุปายาส	Upāyāsa
อุพเพคาปีติ; อุพเพงคาปีติ	Ubbegāpīti; Ubbeṅgāpīti
เอกัคคตา	Ekaggatā
เอตทัคคะ	Etadagga
โอกกันติกาปีติ	Okkantikāpīti
โอชา	Ojā
โอตตัปปะ	Ottappa
โอปปาติกะ	Opapātika
โอวาท	Ovāda
โอวาทปาฏิโมกข์	Ovādapāñimokkha
