A
ปหานะ, จาคะ (การ สละ; การละ)	abandoning; abandonment
วิหาร (ธรรม)	abiding
ภพ; เสนาสนะ, อาลยะ, วิหาร	abode
ปรมัตถ์	absolute sense
ปรมัตถสัจจะ	absolute truth
ฌาน, อัปปนา	absorption
เวรมณี. v. to abstain	abstention
วิรัติ	abstinence
อุปจารสมาธิ	access concentration
ปริวาร, บริวาร (สิ่งของ)	accessory
สหรคต, สหคต	accompanied by
อิทธิบาท	accomplishment, basis of
สัมปทา	achievement
ลาภ	acquisition
โลภ	acquisitiveness
กรรม	act
สังฆกรรม	act, formal
กรรม, กัมมันตะ	action
กัมมัญญตา	adaptability
อเสขะ	adept
สีลัพพต- ปรามาส	adherence to habits and practices
ศาสนิก	adherent
ทมะ	adjustment
โอวาท	admonition
กาเมสุมิจฉาจาร	adultery
อานิสงส์	advantage
อาวัชชนะ	adverting
โอวาท	advice
กัป, กัลป์	aeon
พยาธิ	affliction
วัย	age
ชรา	ageing; aging
ขันธ์	aggregate
ลหุตา	agility
อุทธัจจะ	agitation
อิฏฐะ (น่าปรารถนา)	agreeable
สมมติ (การตกลงร่วมกัน, ~มอบหมาย,	agreement
~แต่งตั้ง)
อัตถะ, อรรถ	aim
กัปปิยะ	allowable adj.
ภิกษา, ทาน, ทานวัตถุ, บิณฑบาต	alms; almsfood
บาตร	alms-bowl
บิณฑบาต, การไปบิณฑบาต	alms-gathering
โคจร (ที่เที่ยวบิณฑบาต, ที่หาอาหาร)	alms resort
การไปบิณฑบาต	almsround
วิปริณาม	alteration
วิภังค์, วินิพโภค	analysis
ปฏิสัมภิทา	analytic insight
โกธะ	anger
อุจเฉทวาท, อุจเฉททิฐิ	annihilationism
อุทธัจจกุกกุจจะ	anxiety
ชวนะ	apperception
พระอรหันต์	Arahat; Arahant
อรหัตต์, อรหัตตผล	Arahatship
ตปะ, ตบะ, อาตปะ, ความเพียรเผากิเลส	ardour
อุปปาทะ, อุบัติ	arising
อริยะ	ariyan
อติมานะ	arrogance
ฤษี, ดาบส, นักพรต, นักบวช	ascetic
ตบะ; ธุดงค์	ascetic practices
อาการ	aspect
สภา, บริษัท (= ปริสา — ที่ประชุมหรือ ชุมชน หมู่ชน ไม่ใช่ บริษัท ในภาษาไทย)	assembly
สัมปยุต	associated with
สัมปโยคะ, เสวนา	association
อุปาทาน	assuming
อุปาทาน	attachment
อภิสมัย (การบรรลุ), สมาบัติ	attainment
อัปปนาสมาธิ	attainment concentration
อุปัฏฐาน (การบำรุง, ~เฝา, ~ พยาบาล)	attendance
หมายเหตุ: ในภาค 3 นี้ เลือกเก็บมาเฉพาะศัพท์ที่ใช้กันในขั้นซึ่งพอจะยุติเป็นแบบได้แล้วบ้าง ศัพท์ที่ควรสังเกตสำหรับผู้ ที่ใฝ่ศึกษาค้นคว้าบ้าง แม้ว่าจะเกินความต้องการของผู้อ่านทั่วไป ก็ถือได้ว่าน่ารู้ (คำที่มีความหมายซึ่งแสดงไว้ แล้วในภาค 1 อาจจะไม่นำมาแสดงไว้ในภาค 3 นี้อีก ผู้ศึกษาพึงค้นเพิ่มเติมในภาค 1 ด้วย)	attendant	อุปัฏฐาก, อุปฐาก.
มนสิการ	 attention
ความมีสติ	attentiveness
สัททารมณ์, สัททะ (เสียง)	audible object
ธุดงค์	austere practices
ตบะ, พรต	austerities
อาณา, อิสริยะ	authority
มัจฉริยะ	avarice
ปฏิฆะ; อรติ	aversion
วิรัติ; สังวร	avoidance
พระพุทธเจ้า	Awakened One, the
อภิสัมโพธิ, การตรัสรู้	Awakening
สัมปชัญญะ	awareness
B
บาป ดู evil	bad
ปาปสหายตา (ความมีเพื่อนชั่ว)	bad company
สมชีวิตา	balanced life; balanced livelihood
ปัพพาชนียกรรม	banishment
สติปัฏฐาน	basis of mindfulness
อิทธิบาท	basis for success
ภพ, ภวะ	becoming
สัตว์	being
สักกายทิฏฐิ	belief in a soul or self
ทาน, อัตถจริยา	benefaction
ทายก	benefactor
อานิสงส์, อัตถะ, อรรถ	benefit
อัตถจริยา	benevolence
มัชชะ	besotting drink
ชาติ	birth
ชาดก	birth story
อนวัชชกรรม (การกระทำอัน ปราศจากโทษ ไม่มีข้อเสียหาย แต่เป็นคุณ ประโยชน์)	blameless action
ภควา (พระผู้มีพระภาค)	Blessed One, the
พร, มงคล, อนุโมทนา, อานิสงส์	blessing
สุข	bliss
พระโพธิสัตว์	Bodhisatta; Bodhisattva
กายิกะ (ทางกาย)	bodily adj.
กายกรรม	bodily action
กายทวาร	bodily avenue
กายสังขาร	bodily formation; bodily functions
กายสุจริต	bodily good conduct
กายิกสุข	bodily happiness
กายทุจริต	bodily misconduct
กายิกทุกข์	bodily pain
กาย	body
โยคะ	bond
พร	boon
ปัจจันตชนบท	border district
สีมา	boundary
คติ	bourn
ดู alms-bowl	bowl
พรหมจารี	Brahma-farer
พรหมจรรย์	Brahma-faring
พราหมณ์	Brahmin, brahman
อัสสาสะ (การหายใจเข้า) (= in-	breathing in
breathing)
ปัสสาสะ (การหายใจออก) (= out-	breathing out
breathing)
พระพุทธเจ้า	Buddha, the
พระพุทธศาสนา	Buddhism
พุทธศาสนิก	Buddhist
ลหุตา (ความเบา)	buoyancy
ธุระ, ภาระ	burden
C
สมถะ	calm
พระมุนี	Calmed One, the
อาสวะ	canker
ปิฎก, คัมภีร์	canon
ปมาทะ, ความประมาท	carelessness
อามิส	carnalities
วรรณะ	caste
ขันธ์	category
ฐาน	causal occasion
เหตุ	cause
ทุกขสมุทัย, สมุทัย	Cause of Suffering
สุสาน	cemetery
นิโรธ	cessation
ทุกขนิโรธ, นิโรธ	Cessation of Suffering
วิปริณาม	change
โคตรภู	change-of-lineage
การสวดมนต์. v. to chant	chanting
คณะ (ในวินัย)	chapter of monks
จริต	character
ลักษณะ	characteristic
ทาน, จาคะ	charity
ทิพยโสต	clairaudience
ทิพยจักษุ	clairvoyance
โคตร, กุล, สายตระกูล	clan
กุลบุตร	clansman
สังคหะ (จัดประเภท)	classification
สัมปชัญญะ	clear comprehension
อุปาทาน	clinging
ดู mental coefficients	coefficients
จิต, จิตต์	cognizance
ธรรมารมณ์	cognizable object
อาโปธาตุ	cohesion, the element of
นิกาย (แห่งคัมภีร์)	Collection
ผาสุก	comfort
อรรถกถา	commentary
สามัญลักษณะ	common characteristics
สังฆะ, สงฆ์	community
สหาย	companion
กรุณา, อนุกัมปา. adj. com-	compassion
passionate
สังขาร, สังขตธรรม	compounded things
สัมปชัญญะ, ปริญญา	comprehension
มานะ	conceit
สมาธิ	concentration
สมาธิภาวนา, สมถ- ภาวนา	concentration development
บัญญัติ	concept
ปฏิสนธิ	conception
สามัคคี	concord
ปัจจัย	condition
ปฏิจจสมุปบาท	conditioned genesis
สังขาร, สังขตธรรม	conditioned things
อาจาร, จริยา, จรณะ, สมาจาร	conduct
confession (อาปัตติ)เทศนา (การแสดงอาบัติ). v
to confess
สัทธา, ศรัทธา, ปสาทะ	confidence
อนุโลม	conformity
ชัย, วิชัย	conquest
ธรรมวิชัย	conquest by piety
หิริ	conscience
ลัชชี, มีหิริโอตตัปปะ	conscientious adj.
วิญญาณ	consciousness
วิบาก	consequence
มนสิการ	consideration
องค์, โวการ	constituent
ผัสสะ	contact
อนุปัสสนา, อนุสติ	contemplation
กายานุปัสสนา	contemplation of the body
เวทนานุปัสสนา	contemplation of the feelings
จิตตานุปัสสนา	contemplation of the mind
ธัมมานุ-  ปัสสนา	contemplation of the mind-objects
มักขะ; อติมานะ	contempt
สันโดษ, สันตุฏฐี	content; contentment
สันตติ, สันตานะ	continuity
อินทรียสังวร	control of the senses
อินทรีย์	controlling faculty
สมมติสัจจะ	conventional truth
อาวัตต์, อาวัตตนา, การกลับใจเปลี่ยน ศาสนา	conversion
สหธรรมิก	co-religionist
รูป, รูปธรรม	corporeality
สังกิเลส, อุปกิเลส, อาสวะ	corruption
สังคายนา, สังคีติ	Council
ปฏิภาค	counterpart
ทุกะ (หมวดสอง)	couplet
กรรมบถ	course of action
ปิยวาจา, เปยย- วัชชะ	courteous speech; courtesy
อภิชฌา	covetousness
ตัณหา	craving
วิภวตัณหา	craving for annihilation
ภวตัณหา	craving for existence
วิภวตัณหา	craving for non-existence
กามตัณหา	craving for sensual pleasures
ฌาปนกิจ	cremation
ฌาปนสถาน	crematorium
วิหิงสา	cruelty
ดู mind culture	culture
ทธิ	curds
 D
อันตราย, อาทีนพ	danger
มรณะ, มัจจุ, จุติ	death
อมตะ	deathless adj
อิตถีธุตตตา (ความเป็นนักเลงหญิง)	debauchery
ทสกะ (หมวดสิบ)	decad
ชรา, ชรตา	decay
จุติ	decease
มายา	deceit
เยภุยยสิกา	decision of the majority
ปราภวะ (ความเสื่อม)	decline
กรรม	deed
อาบัติปาราชิก	defeat, offence involving
กิเลส	defilement
ววัตถาน	definition
วิมุตติ, วิโมกข์	deliverance
โมหะ	delusion
บาปกรรม	demeritorious action
อสูร, ยักษ์	demon
นิทเทส	demonstration
มักขะ	denigration
นิสสัย (ในวินัย)	dependence
ปฏิจจสมุปบาท	dependent origination
อิริยาบถ	deportment
อุปาทายรูป	derivative matter
อุปาทายรูป	derived materiality
บัญญัติ	description
อธิวจนะ, อธิพจน์	designation
ฉันทะ, กาม, ตัณหา, อิจฉา (ความอยาก)	desire
อุปายาส (ความผิดหวัง, ความคับแค้นใจ)	despair
คติ	destination
พยสนะ, หายนะ, วินาส, ปหานะ, ขยะ	destruction
ปาณาติบาต	destruction of life
วิราคะ	detachment
มักขะ	detraction
ภาวนา	development
อุบาสก, อุบาสิกา	devotee, lay
พระธรรม, ธรรม	Dhamma; Dharma, the
อัปปมาทะ, อุฏฐานะ (ความหมั่นขยัน)	diligence
อภิญญา	direct knowledge
จุติ, อันตรธาน	disappearance
วิจักขณา	discernment
สาวก	disciple
วินัย	discipline
อรติ, อนภิรติ (ความไม่ยินดี, เบื่อ หน่าย)	discontent
พุทธิ, โพธิ	discovery
ปฏิสัมภิทา	discrimination
วิจาร	discursive thinking
สากัจฉา	discussion
โรค, พยาธิ (ความเจ็บไข้)	disease
ปลาสะ	disparaging
นิพพิทา	dispassion
ศาสนธรรม, พระศาสนา	dispensation
วิวาท	dispute
ธรรมบรรยาย	disquisition
ความร้าวราน, ความแตกแยก, สังฆราชี 	dissension (in the Order)
อุทธัจจะ, วิกเขปะ (ความฟุงซ่าน)	distraction
ปปัญจะ	diversification
ทิพย์, พรหม	divine
ดู sublime states	divine abiding	พรหมวิหาร.
ทิพยโสต	divine ear
ทิพยจักษุ	divine eye
ดู holy life	divine life	พรหมจรรย์.
ธรรม, พระธรรม, ปาพจน์	doctrine
วิสัย, ภพ	domain
ปลาสะ	domineering
ทาน, การบริจาค	donation
ทายก	donor
ทวาร	door
วิจิกิจฉา, กังขา	doubt
ปราภวะ (ความเสื่อม), อบาย	downfall
มิทธะ	drowsiness
สุราธุตตตา (ความเป็นนักเลงสุรา)	drunkenness
โมหะ	dulness; dullness
ราชธรรม	duties of the King; duties of the ruler
กิจ, วัตร	duty
วิหาร (ที่อยู่)	dwelling
ปฏิรูปเทสวาส	dwelling in a favourable place
ทุกะ (หมวดสอง)	dyad
 E
โสตะ	ear
อัปปมาทะ, อาตาปะ (ความเพียร)	earnestness
ดู extension	earth	ปฐวี, ปฐวีธาตุ.
สุข	ease
วิริยะ, วายามะ, ความเพียรพยายาม	effort
อัตตา, อาตมัน	ego
มุทุตา	elasticity
เถระ	elder
ธาตุ, มหาภูต, องค์	element
โพชฌงค์	elements of enlightenment
สักกายทิฏฐิ	embodiment view
กลละ, คัพภะ	embryo
วุฏฐานะ (การออก)	emergence
สุญญตา	emptiness
อันตะ	end
ปธาน, วิริยะ, วายามะ	endeavour
ขันติ, อธิวาสนะ	endurance
วิริยะ	energy
บริโภค (เสวย; ใช้กับสมบัติ ความสุข  เป็นต้น); อัสสาทะ	enjoyment
พระพุทธเจ้า	Enlightened One, the
โพธิ, อภิสัมโพธิ (การตรัสรู้)	enlightenment
โพชฌงค์	enlightenment factor
โพธิปักขิยธรรม	enlightenment state
นวกะ (หมวดเก้า)	ennead
ปีติ	enthusiasm
อิสสา, ความริษยา	envy
กัป, กัลป์	eon
สมานัตตตา	equality
ดู on-	equanimity	อุเบกขา (ตัตรมัชฌัตตตา).
looking equanimity
บริขาร	equipment
สมุคฆาตะ, ปหานะ	eradication
นิสสรณะ	escape
อุปธิ	essential of existence
สัสสตวาทะ, สัสสตทิฏฐิ	eternalism; eternity-view
บัณเฑาะก์ (จำพวกหนึ่ง)	eunuch
อุเบกขา	even-mindedness
บาป	evil
มาร	Evil One, the
ภควา (พระผู้มีพระภาค)	Exalted One, the
ปธาน, วายามะ, ปรักกมะ, ความเพียร, ปัคคหะ, ปัคคาหะ	exertion
ขยะ, ขัย (ความสิ้นไป, ความหมดไป)	exhaustion
โอวาท	exhortation
ภพ	existence
เวทยิต	experience
นิทเทส, วรรณนา	exposition
ปฐวีธาตุ	extension, the element of
นิโรธ	extinction
กิเลสปรินิพพาน (= สอุปาทิเสสนิพพาน)	Extinction of Impurities
ทุกขนิโรธ, นิโรธ	Extinction of Suffering
ขันธปรินิพพาน (= อนุปาทิเสสนิพพาน)	Extinction of the Five-Khandha-Process
อันตะ (ที่สุด, ความเข้าใจ หรือ ประพฤติ เอียงสุด)	extreme
อาบัติปาจิตตีย์	expiation, offence of
จักขุ	eye
F
องค์	factor
อินทรีย์	faculty
ตัณหักขยะ	fading away of craving
วิราคะ	fading of lust
วิบัติ	failure
ดู confidence	faith	ศรัทธา.
มิจฉัตตะ	falseness; falsity
มุสาวาท	false speech
มิจฉาทิฏฐิ	false views
ยศ, กิตติศัพท์, สิโลกะ	fame
สัปปายะ	favourable adj.
ภยะ	fear
โอตตัปปะ	fear of blame
เวทนา	feeling
อิตถีภาวะ, อิตถินทรีย์	femininity
สังโยชน์, สัญโญชน์	fetter
อัญญา	final knowledge
รูปภพ, รูปโลก	Fine-Material Sphere
ธิติ	firmness
เบญจศีล	Five Precepts, the
อุปาทาน	fixation
รส	flavour
โอฆะ	flood
อาโปธาตุ ดู cohesion	fluid element
อุทธัจจกุกกุจจะ	flurry and worry
สาวก, ศาสนิก	follower
พาล, คนพาล	fool
โมฆบุรุษ	foolish man
ตีติกขา, ขันติ	forbearance
อรัญวาสี	forest-dweller
อาบัติ นิสสัคคิยปาจิตตีย์	forfeiture, offence of expiation involving
รูป	form
สังฆกรรม	formal act
อาบัติสังฆาทิเสส	formal meeting of the Order, offence entailing a
สังขาร	formations
บุพกรณ์	former action
บุพเพนิวาส	former habitation
อรูป	formless
อนุโลม	forward order
สติปัฏฐาน	foundation of mindfulness
สุคนธ์	fragrant adj.
พระคันธกุฎี	Fragrant Cell, the
สาเฐยยะ, สาไถย	fraud
วิมุตติ	freedom
มิตร	friend
เมตตา	friendliness
สัมผัปปลาปะ	frivolous talk
ผล, วิบาก	fruit; fruition
พระสัมมาสัมพุทธเจ้า	Fully Enlightened One, the
บุณมี, บูรณมี, วันเพ็ญ	full moon; full-moon day
กิจ, รส	function
กิริยาจิต	functional consciouness
ปาฏิโมกข์	fundamental precepts
สติปัฏฐาน	fundamentals of mindfulness
G
ลาภ	gain
การพนัน	gambling
จาคะ, ทาน	generosity
มัททวะ	gentleness
กายวิญญัติ	gesture
สัปปิ	ghee
เปรต	ghost
ทาน, ทานวัตถุ	gift
ทาน	giving
จาคะ, ปริจจาคะ	giving up
อัตถะ, ปริโยสาน	goal
เทวะ, เทพ, เทวดา	god
going forth (from home) ปัพพัชชา
อัตถะ. adj.  กัลยาณะ, บุญ	good n.
กัลยาณมิตตตา	good company
สัมผัปปลาปะ	gossip
อุปาทาน	grasping
กตัญญู	grateful adj.
กตัญญุตา, กตัญญูกตเวทิตา	gratefulness
อัสสาทะ	gratification
กตัญญุตา, กตัญญูกตเวทิตา	gratitude
อาบัติถุลลัจจัย	grave offence
มหาภูต	great entity
มหาบุรุษ	Great Man
มหาภิเนษกรมณ์	Great Renunciation, the
มหายาน	Great Vehicle
โลภะ	greed
มหิจฉตา (ความมักมากอยากใหญ่)	greediness
โทมนัส, โสกะ	grief
คณโภชน์	group-meal
ขันธ์ 5	Groups of Existence, the Five
อุปจยะ	growth
อุปนาหะ	grudging
นิสสัย (ในวินัย)	guidance
สรณะ, เนตติ	guide
วินัย	guiding out
กุหนา	guile
 H
ปภา	halo
สุข	happiness
อหิงสา	harmlessness
สามัคคี	harmony
ผรุสวาจา	harsh speech
โทสะ	hate
โทสะ, เวร	hatred
อาโรคยะ, กัลลตา	health
ดู disciple	hearer	สาวก.
หทัย	heart
เตโชธาตุ	heating element
สัคคะ, สวรรค์	heaven
ทิพยวิหาร	heavenly abiding
เทพ, เทวดา, ชาวสวรรค์	heavenly being
ทิพยโสต	heavenly ear
ทิพยจักษุ	heavenly eye
อัปปมาท	heedfulness
ปมาทะ, ความประมาท	heedlessness
นิรยะ นรก	hell
สังคหะ	help
สัตตกะ (หมวดเจ็ด)	heptad
ทิฏฐธรรม, ทิฏฐธัมม์	here and now
ปรโลก, สัมปรายะ	hereafter
ติตถายตนะ	heresy
ทายัชชะ (ความเป็นทายาท, มรดก)	heritage
ปัจเจกพุทธ	hermit enlightened one
ฉักกะ (หมวดหก)	hexad
ดู superknowledge	higher knowledge
อธิจิตต์	higher mentality
อธิศีล	higher morality
อธิจิตต์	higher thought
อธิปัญญา	higher wisdom
นิวรณ์	hindrance
พรหมจรรย์	holy life
สมณพราหมณ์	holy men
พระอริยะ, พระอรหันต์	holy one
นมะ, นมักการะ, ปูชา	homage
อนาคาริก	homeless one
อนาคาริยะ, ชีวิตอนาคาริก	homeless life
อาชชวะ	honesty
สักการะ, ปูชา	honour
เวร	hostile action
คฤหบดี, คฤหัสถ์	householder
ฆราวาส, ชีวิตคฤหัสถ์;  การครองเรือน	house-life; household life
มนุษย์	human being
นิวาตะ; อปจายนะ (ความอ่อนน้อมถ่อม ตน). adj. humble	humility
กุฎี (กระท่อม)	hut
สาเฐยยะ, สาไถย	hypocrisy
I
ดู perception	ideation	สัญญา.
โกสัชชะ	idleness
อนริยะ, อนารยะ	ignoble adj.
อวิชชา	ignorance
อัปปมัญญา	illimitables
โอภาส	illumination
ปโมหะ, มายา	illusion
พยาบาท	ill-will
ดู mental image	image	ปฏิมา.
อหังการ	I-making
อรูป	immaterial adj.
อรูปภพ, อรูปโลก	Immaterial Sphere
บาป, อกุศล	immoral adj.
อมตะ	immortal adj.
สมานัตตตา	impartiality
ปลิโพธ, กิญจนะ	impediment
อนิจจตา	impermanence
อนิจจะ, อนิจจัง	impermanent adj.
อาเนญชา, อเนญชา	imperturbability
ชวนะ	impulsion
กิเลส, มละ, มลทิน	impurity
อานาปานะ, อัสสาสะ ปัสสาสะ	in- and out-breathing
มนต์, มนตร์	incantation
ธูป	incense stick
อัชฌาสัย, อธิมุติ	inclination
อนิสสิต	independent adj.
อัพยากฤต	indeterminate adj.
อุเบกขาเวทนา, อทุกขมสุข	indifferent feeling
บุคคล	individual
อัตตภาวะ, อัตภาพ	individuality
โกสัชชะ	indolence
อนลสตา, อุฏฐานะ (ความหมั่นขยัน)	industry
ปฐวีธาตุ	inertia
อนันต์	infinite adj.
วิญญาณัญจายตนะ	infinity of consciousness
อากาสานัญจายตนะ	infinity of space
ดู  heritage	inheritance	ทายัชชะ.
อัชฌัตติกายตนะ (อายตนะ ภายใน)	inner sense-sphere
วิตก	initial application
วิมังสา, ปริปุจฉา	inquiry
ญาณ, วิปัสสนา	insight
วิปัสสนาภาวนา	insight development
ปรจิตตวิชานน์, เจโตปริยญาณ	insight into the hearts of others
อภินิเวส	insistence
สสังขาริก	instigated adj.
อนุสาสนี, สาสนะ	instruction
อาชชวะ	integrity
สังกัปปะ, อธิปปายะ, เจตนา	intention
วิญญัติ	intimation
มัชชะ, นํ้ าเมา, สุราเมรัย	intoxicant
อาสวะ	intoxicant, mental
เวสารัชชะ	intrepidity
วิจัย, สันตีรณะ, วิโลกนะ	investigation
ธัมมวิจยะ, ธรรมวิจัย	investigation of the Dhamma
การนิมนต์, อาราธนา, ปวารณา	invitation
ภัตตุเทศก์	issuer of meals
J
อิสสา, ความริษยา	jealousy
รัตนะ (ใน “รัตนตรัย”)	jewel
ดู sympathetic joy	joy	โสมนัส, (เจตสิก) สุข, ปีติ, มุทิตา.
K
กรรม	Kamma; Karma
อุปาทินนะ, กรรมชะ	karmically acquired adj.
ปาณาติบาต	killing
ปิยวาจา	kindly speech
ญาติ	kinsman
เญยยธัมม์, ไญยธรรม	knowable things
ญาณทัสสนะ	knowing and seeing
ญาณ, วิชชา	knowledge
L
พวกคฤหัสถ์, พวกชาวบ้าน	laity, the
ปริเทวะ	lamentation
อนุสัย	latent bias
อนุสัย	latent tendency
พระธรรม	Law, the
อุบาสก อุบาสิกา	lay devotee
อุบาสก, คฤหัสถสาวก	lay disciple
อุบาสก, พุทธศาสนิกฝ่ายคฤหัสถ์	lay follower
การบัญญัติ(สิกขาบท). v. to lay down	laying down
คฤหัสถ์	layman
โกสัชชะ, อาลัสยะ	laziness
เสขะ	learner
สุตะ, สิกขา	learning
อธิกรณ์	legal question
หีนยาน	Lesser Vehicle
ถีนะ	lethargy
ถีนมิทธะ	lethargy and drowsiness
อักขระ, พยัญชนะ	letter
ทาน, จาคะ	liberality
วิโมกข์, วิมุตติ	liberation
ชีวิตินทรีย์	life-faculty
ชีวะ, ชีวิตินทรีย์	life-principle
อายุ, ชีวกาล, ชนมกาล, อายุกัป	life-span
ลหุตา	lightness
สุรา	liquor
อาชีวะ	livelihood
ปฏิรูปเทสวาส	living in befitting places
สมชีวิตา	living within one’s means
ปฏิกูล. n. loathsomeness	loathsome adj.
เสนาสนะ	lodgings
อิจฉา (ความอยาก)	longings
เปมะ, เปรม	love
เมตตา	loving-kindness
ทางจันทรคติ	lunar adj.
ปฏิทินจันทรคติ	lunar calendar
ราคะ	lust
ฉันทราคะ	lusting wish
ดู false speech	lying; lying speech
M
อิทธิปาฏิหาริย์	magical power
มหายาน (นิกายพระพุทธศาสนาฝ่าย เหนือ)	Mahayana
อนุรักขนา	maintaining; maintenance
อาฆาต	malice
ปิสุณาวาจา, เปสุญวาท	malicious speech
มุทุตา	malleability
วิธาน, สังวิธาน (การจัดการ)	management
ปัจจุปัฏฐาน	manifestation
ปริยาย, อาการ	manner
ปาฏิหาริย์	marvel
ปุริสภาวะ, ปุริสินทรีย์	masculinity
สมูหะ, ฆนะ	mass
พระศาสดา, พระบรมศาสดา	Master, the
วสี	mastery
อามิสทาน	material gifts
สามิสสุข	material happiness
รูปธรรม, รูป	material qualities
อามิส	material things
อามิสบูชา	material worship
มาตุฆาต	matricide
มาติกา	matrix
ชฎิล	matted-hair ascetic
รูป	matter
ปริปากะ	maturity
ภัต, โภชนะ	meal
ภัตตกาล	mealtime
อรรถ	meaning
มัจฉริยะ	meanness
อุปายะ, อุบาย, วิธี, ปโยคะ	means
เภสัช	medicine
ฌาน, ภาวนา	meditation
ฌายี, ผู้บำเพ็ญฌาน, นักฌาน, ผู้เจริญ ภาวนา	meditator
โสวจัสสตา	meekness
เจตสิกะ (ทางใจ)	mental adj.
มโนกรรม	mental action
เจตสิก	mental activities
เจตสิก	mental adjuncts
มโนทวาร	mental avenue
นามกาย	mental body
เจตสิก	mental coefficients
เจตสิก	mental concomitants
เจตสิก	mental factors
มโน- สังขาร, จิตตสังขาร	mental formations; mental functions
สังขาร (ในขันธ์ 5)	mental formations
มโนสุจริต	mental good conduct
เจตสิกสุข	mental happiness
นิมิต, นิมิตต์	mental image
นาม, นามธรรม, เจตสิก	mentality
มโนทุจริต	mental misconduct
ธรรมารมณ์	mental object
เจตสิกทุกข์	mental pain
เจตสิก	mental qualities
ทยา, อนุทัย (ความปรานีเอ็นดู)	mercy
บุญ	merit
บุญกรรม	meritorious action
พระธรรม, คำสอน	message
มัชฌิมาปฏิปทา	Middle Path, the
มัชฌิมาปฏิปทา	Middle Way, the
จิต, มโน, นาม	mind
ภาวนา	mind culture
สติ	mindfulness
อานาปานสติ	mindfulness on breathing
ดู mental object	mind object
ปาฏิหาริย์	miracle
สีลัพพตปรามาส	misapprehension of virtue and duty
ทุจริต, มิจฉาจาร	misconduct
มัจฉริยะ	miserliness
ทุกข์. adj. miserable	มีทุกข์, เป็นทุกข์	misery
อาการ	mode
มัตตัญญุตา (~ in eating = โภชเนมัตตัญญุตา)	moderation
ขณะ	moment
ขณิกสมาธิ	momentary concentration
ขณิกาปีติ	momentary joy
วัด, อาราม, วิหาร	monastery
พรหมจรรย์, ชีวิตสมณะ	monastic life
ภิกขุ, ภิกษุ, สมณะ	monk
ถูปะ, สถูป, เจติยะ, เจดีย์	monument
สีลสมบัติ, สีลสัมปทา	moral achievement
โอตตัปปะ	moral dread
สีลวิบัติ	moral failure
ศีล	moral habit
ศีล	morality
หิริ	moral shame
มัจจะ (ผู้ต้องตาย = สัตว์)	mortal
ญัตติ, ญัติ; วาโยธาตุ	motion
โลกิยะ, โลกีย์	mundane adj.
มมังการ	my-making
N
อเจลก	naked ascetic
นาม	name
นามรูป	name and form
ปกติศีล	natural virtue
ปมาทะ, ความประมาท	negligence
อุปจารสมาธิ	neighbourhood concentration
อทุกขมสุข, อุเบกขาเวทนา	neither-pain-nor-pleasure
เนวสัญญานาสัญญายตนะ	Neither Perception Nor Non-Perception, Sphere of
ตัตรมัชฌัตตตา	neutrality, specific
นวกภิกษุ	newly ordained monk
ปุนชาติ, ปุนภพ, ชาติหน้า, ปรโลก	next life; next world
นิพพาน	Nibbāna; Nirvāṇa
อนุปาทิเสสนิพพาน	Nibbāna without any remainder of existence
สอุปาทิเสสนิพพาน	Nibbāna with remainder of existence
มัจฉริยะ	niggardliness
นัตถิกวาท, นัตถิกทิฏฐิ	nihilism
อริยะ, อารยะ	noble adj.
อริยสาวก	noble disciple
อริยวินัย (แบบแผนของอารยชน)	noble discipline
อริยอัฏฐังคิกมัคค์, อารยอัษฎางคิกมรรค	Noble Eightfold Path, the
อริยบุคคล	noble one
อริยทรัพย์	noble treasure
อริยสัจจ์ 4, จตุราริยสัจจ์	Noble Truths, the Four
อริยทรัพย์	noble wealth
อนภิชฌา	non-covetousness
อวิหิงสา	non-cruelty
อโมหะ	non-delusion
อโลภะ	non-greed
อโทสะ, อพยาบาท	non-hate; non-hatred
อพยาบาท	non-ill-will
อหิงสา	non-injury
อวิโรธนะ	non-obstruction
อวิโรธนะ	non-opposition
อนาคามี	Non-Returner
อนาคามิผล	Non-Returning, fruition of
อนาคามิมรรค	Non-Returning, path of
อนัตตา	non-self; non-soul
อหิงสา, อวิหิงสา	non-violence
ธรรม	norm
ฆานะ	nose
อากิญจัญญายตนะ	Nothingness, Sphere of
อนัตตา	not-self adj.
สามเณร	novice
สามเณร, นวะ	novitiate
ภิกษุณี	nun
อาหาร	nutrient; nutriment
โอชา	nutritive essence
 O
โสวจัสสตา	obedience
อารมณ์	object
วิสัย	objective-field
ตถตา	objectivity
พลี, พลีกรรม	oblation
ปาติโมกข์, กิจ, ธุระ, พันธะ	obligations
อุโบสถ, วัตร, การรักษา (ศีลเป็นต้น)	observance
ปริยุฏฐานะ, ปปัญจะ	obsession
ถัมภะ	obstinacy
ดู hindrance	obstruction	นิวรณ์.
อัฏฐกะ (หมวดแปด)	octad
คันธารมณ์	odorous object
คันธะ	odour
อาบัติ	offence
พลี, ทักขิณา, ทักษิณา, บูชา	offering
ชรา	old age
ฆานะ	olfactory organ
นิมิต; good omen	มงคล	omen
สัพพาภิภู	omnipotent adj.
สัพพัญญุตา	omniscience
พระสัพพัญญู	Omniscient, the
สกทาคามี	Once-Returner
สกทาคามิผล	Once-Returning, fruition of
สกทาคามิมรรค	Once-Returning, path of
เอกัคคตา, จิตตัสเสกัคคตา	one-pointedness of mind
อุเบกขา	onlooking-equanimity
ปฏิปักข์	opposite adj.
พระสงฆ์, คณะสงฆ์	Order, the
ดู worldling	ordinary man
อุปสัมปทา, การอุปสมบท. v. to be 	ordination
ordained
สมุทัย	origin
ทุกขสมุทัย, สมุทัย	Origin of Suffering
สมุฏฐาน	origination
ปรโลก	other world
พาหิรายตนะ (อายตนะภาย นอก)	outer sense-sphere
วสละ (คนถ่อย, ~ตํ่ าทราม)	outcast
จัณฑาล	outcaste
ปหานะ	overcoming
อัตถิสุข (สุขเกิดจากความ มีทรัพย์)	ownership, the bliss of
P
ทุกข์	pain
ทุกขเวทนา	painful feeling
พระไตรปิฎก	Pali Canon
ปรินิพพาน	Parinirvana
มาตุฆาตหรือปิตุฆาต	parricide
ฉันทาคติ	partiality
มรณะ, กาลกิริยา	passing away
มรรค	Path, the
ขันติ, ขมะ	patience
ปิตุฆาต	patricide
สันติ, อุปสมะ	peace
ปฏิเวธ, นิพเพธ	penetration
ปัญจกะ (หมวดห้า)	pentad
สัญญา	perception
วินิบาต	perdition
พระตถาคต	Perfect One, the
บารมี	perfection
สัมปัตติ, สมบัติ	perfectness
อาทีนพ, ภัย	peril
วิจิกิจฉา	perplexity
บุคคล	person
ปฏิภาณ	perspicuity
วิปัลลาส	perversion
กายิกะ (ทางกาย). ดู bodily	physical adj.
หทัยวัตถุ	physical basis of mind
ภูมิ	plane
สุขเวทนา	pleasant feeling
ปาสาทิกะ (น่าเลื่อมใส)	pleasing adj.
สุข	pleasure
อิริยาบถ	posture
พละ	power
การปฏิบัติ, ปฏิปทา	practice
วัณณะ (คำสรรเสริญ), ปสังสา	praise
เทศนา. v. to preach	preaching
สิกขาบท, (ข้อ) ศีล	precept
อุปัชฌาย์	preceptor
อธิปไตย	predominance
อคติ	prejudice
บุพกิจ	preliminary duties
บริกรรม (การตระเตรียม)	preparation
สารัมภะ	presumption
บุพการี	previous benefactor
ปุริมชาติ, บุพชาติ, ชาติก่อน	previous life
มานะ, มทะ	pride
นักบวช, พราหมณ์	priest
มหาภูต	primary element
อานิสงส์	privilege
ปริวาส	probation
สิกขมานา	probationer
อนุสาวนา	proclamation
ปาคุญญตา; โกศล	proficiency
อายโกศล	proficiency as to progress
อปายโกศล	proficiency as to regress
อุปาย โกศล	proficiency as to the means of success
อายโกศล	proficiency in knowing gain
อปายโกศล	proficiency in knowing loss
อุปายโกศล	proficiency of method
กุศล	profitable adj.
คัมภีร์, ลึกซึ้ง	profound adj.
สสังขาริก	prompted adj.
การเผยแผ่	propagation
สมบัติ	property
วยากรณะ, ไวยากรณ์ (คำร้อยแก้ว)	prose; prose-exposition
สัมปทา	prosperity
อารักขา	protection
นิทาน (เหตุ, ที่มา)	provenance
อภิญญา	psychic power
สัทธิวิหาริก หรือ อันเตวาสิก, ศิษย์	pupil
สุทธาวาส	Pure Abodes
วิสุทธิ	purification
ปาริสุทธิ, วิสุทธิ	purity
อธิปบาย (นัยประสงค์)	purport
อนุโยค	pursuit
Q
สัตว์จตุบท	quadruped
คุณ, ลักษณะ, องค์	quality
กลหะ, วิวาท	quarrel
ทิศ (ทิสา)	quarter
เอสนา, คเวสนา, ปริเยสนา	quest
ปัญหา	question
สมถะ. adj. วิวิตต์ (สงัด)	quiet n.
R
เตโชธาตุ; การแผ่ (เมตตา บุญกุศล ฯลฯ)	radiation
บังสุกุลจีวร	rag-robe
จำพรรษา, วัสสาวาสะ	rains-residence; rains-retreat
ปีติ	rapture
ปัตติ (การบรรลุ)	reaching
ตถตา, ยถาภูตธรรม	reality
สัจฉิกิริยา, สัจฉิกรณะ, อธิคม (การทำ ให้แจ้ง, การบรรลุ)	realization
อุปบัติ	reappearance
การณะ, โยนิ, วิมังสา	reason
ปุนภพ, ชาติใหม่, การเกิดใหม่	rebirth
ปฏิคาหก, ลาภี	recipient
การสาธยาย, การสวด. v. to recite	recitation
สมณะ	recluse
อนุสติ	recollection
ปฏิสาราณียกรรม	reconciliation
ปฏิสนธิ	reconnection
อุชุกตา	rectitude
ภัตตัคคะ (โรงฉัน, หอฉัน)	refectory
สังยมะ, สัญญมะ, เวรมณี	refraining
สรณะ	refuge
ไตรสรณะ	Refuge, the Threefold
บังสุกุลจีวร	refuse-rag-robe
ตทารมณ์, ตทาลัมพนะ	registration
สังคีติ, สังคายนา	rehearsal
อวตาร (ตามคติพราหมณ์, ฮินดู)	reincarnation
ญาติ	relative; relation
ปัสสัทธิ	relaxation
วิโมกข์, วิมุตติ	release
relics (of the Buddha) พระธาตุ, พระสารีริกธาตุ
ภาพสลักนูน, รูปนูน	relief
ปฏิสนธิ	relinking
ปุพเพนิวาสานุสสติญาณ	remembrance of previous births
วิปฏิสาร, กุกกุจจะ	remorse
ปริจจาคะ	renouncing
กิตติ, กิตติศัพท์	renown
เนกขัมมะ. v. to renounce	renunciation
นวกรรม, ปฏิสังขรณ์	repairs
โจทก์	reprover
โจทนา. v. to reprove	reproving
ปฏิฆะ	repugnance
ปฏิฆะ	repulsion
ปฏิกูล	repulsive adj.
บริขาร, ปัจจัย	requisite
ปฏิฆะ	resentment
ปฏิฆะ	resistance
อธิโมกข์, อธิมุติ; (วินัย) กรรมวาจา	resolution
อธิษฐาน, อธิมุติ	resolve
โคจร	resort
คารวะ	respect
ครุฐานียบุคคล	respectable person
อุทธัจจะ, วิชัมภิตา	restlessness
โอสารณา; ปฏิสังขรณ์	restoration
สังวร, สังยมะ	restraint
อินทรียสังวร	restraint of the senses
ผล, วิบาก	result
ปุพเพนิวาสานุสติญาณ (เทียบ)	retrocognition
อปจายนะ, คารวะ	reverence
ดู Venerable	Reverend	คำเรียกนำหน้าชื่อพระสงฆ์ แสดงคารวะ นิยมใช้กับพระสงฆ์ผ่ายมหายานหรือนักบวชใน ศาสนาอื่น.
ปฏิโลม	reverse order
ปัจจเวกขณ์	review; reviewing
โภคะ	riches
สัมมา	right adj.
สัมมากัมมันตะ	Right Action
สัมมาสมาธิ	Right Concentration
ดู Right Action	Right Conduct
สัมมาวายามะ	Right Effort
สัมมัปปธาน	right endeavour
สัมมาวิมุตติ	Right Deliverance
ดู Right Thought	Right Intent
สัมมาญาณะ	Right Knowledge
สัมมาอาชีวะ	Right Livelihood
ดู Right Livelihood	Right Means of Livelihood
ดู Right Concentration	Right Meditation
สัมมาสติ	Right Mindfulness
ดู Right Thought	Right Motives
สัมมาวาจา	Right Speech
สัมมัปปธาน	right striving
สัมมาสังกัปปะ	Right Thought
สัมมาทิฏฐิ	Right Understanding
ดู Right Understanding	Right View
ธรรมิก, เป็นธรรม	righteous adj.
สัปบุรุษ, สัตบุรุษ	righteous man
ธรรม	righteousness
สัมมัตตะ	rightness
ถัมภะ	rigidity, mental
วิบาก	ripening
เวร	risk
สีลัพพตะ	rites and rituals
ปลาสะ, สารัมภะ	rivalry
ดู basis for success	road to power	อิทธิบาท.
จีวร	robe
มูล	root
เหตุ	root-cause
วัฏฏะ	round
สังสารวัฏฏ์, วัฏฏสงสาร, สงสาร	round of rebirth; roundabout of births
สันถัต	rug
สีลัพพตะ, ศีลและพรต	rules and rituals
สิกขาบท	rule of training
วิจาร	rumination
 S
ยัญ (พราหมณ์); จาคะ, ปริจจาคะ	sacrifice
เขมะ, เกษม	safe adj.
กาสาวพัสตร์	saffron robe
มุนี	sage
วิมุตติ	salvation
อุปาหนา	sandals
สงฆ์, พระสงฆ์, คณะสงฆ์	Sangha, the
รสารมณ์	sapid object
ปสาทะ, อัสสาทะ	satisfaction
พระมหาไถ่, พระผู้ไถ่บาป (คริสต์ = พระ เยซู; เคยมีผู้นำมาใช้เลียนศัพท์แทน นาถะ บ้าง แต่บัดนี้ไม่ใช้กันแล้ว)	Saviour
รส	savour
วิจิกิจฉา	scepticism
มาติกา	schedule
สังฆเภท	schism
นิกาย (แห่งศาสนา)	School
วิชชา	science
คัมภีร์, คันถะ, ปกรณ์	scripture
เอสนา, ปริเยสนา (การแสวง หา)	search; searching
ธัมมวิจยะ	search of truth
อาสนะ	seat
วิเวก	seclusion
นิกาย	sect
วาระ, วรรค	section
ทัสสนะ	seeing
อิสิ, ฤๅษี	seer
อัตตา, ตน, ตัวตน	self
ทมะ, สัญญมะ	self-control
อัตตสัมมาปณิธิ	self-direction, right disposition in
สักกายทิฏฐิ	self-illusion
มัจฉริยะ	selfishness
อัตตัญญุตา	self-knowledge
อัตตกิลมถานุโยค	self-mortification; self-torment
สัมปชัญญะ	self-possession
ดู feeling	sensation	เวทนา.
อายตนะ	sense-base
อายตนะ	sense-field
ผัสสะ	sense-impression
หิริ	sense of shame
สังเวคะ, ความสังเวช	sense of urgency
อายตนะ(ภายนอก)	sense-object
อายตนะ(ภายใน), อินทรีย์	sense-organ
กาม	sense-pleasure
อายตนะ	sense-sphere
กามตัณหา	sensual craving
กาม, กามฉันทะ	sensual desire
กามสุขัลลิกานุโยค	sensual indulgence
กามราคะ	sensual lust
กาเมสุมิจฉาจาร	sensual misconduct
กามภูมิ	Sensual Plane
กาม, กามสุข, กามคุณ	sensual pleasure
กามภพ	Sensual Sphere
กามตัณหา	sensuous craving
กามภพ, กามโลก	sensuous sphere
สัตว์	sentient being
วิภังค์	separate treatment
อนุสนธิ	sequence
สันตะ (ผู้สงบระงับ)	serene adj.
สันตติ	series
เวยยาวัจจะ	service
setting in motion (หรือ setting rolling) the 
ธัมมจักกัปปวัตตนะ	Wheel of the Doctrine
สติปัฏฐาน	setting-up of mindfulness
โสดาบัน ผู้สัตตักขัตตุปรมะ	Seven-Times-at-Most Stream-Enterer
เมถุนธรรม	sexual intercourse
กาเมสุมิจฉาจาร	sexual misconduct
หิริ, ลัชชา	shame
อลัชชี	shameless adj.
ตาณะ (ที่พำนัก, ที่ต้านทาน, ที่กันภัย)	shelter
ปาทุกา	shoe
นิมิต	sign
ไตรลักษณ์	Signs of Being, the Three
อุปมา	simile
อัปปิจฉตา, ความมักน้อย	simplicity
เอกพีชี	single-seed
กุศลกรรม	skilful action
โกสัลละ, โกศล, ทักขะ, ทักษะ	skill
กุศล	skilled; skilful adj.
ปิสุณวาจา, ปิสุณาวาจา, เปสุญวาท	slander
ถีนะ, ลีนตา	sloth
มักขะ	smirching
สมานัตตตา	sociability
มุทุตา; มัททวะ	softness
ปฐวีธาตุ	solid element
วิเวก	solitude
โสกะ, โศก	sorrow
สัททะ (เสียง)	sound
นิทาน (เหตุ, ที่มา)	source
อัตตา, อาตมัน, ชีวะ	soul
อนัตตา	soulless adj.
อนัตตตา	soullessness
อากาส (ช่องว่าง), อวกาศ	space
อิทัปปัจจยตา	specific conditionality
วิภาค	specification
วาจา, วจี, ภาสิต, วจีวิญญัติ	speech
อุปนาหะ	spite
โอปปาติกะ	spontaneously born creature
มละ, มลทิน	stain
standing (in the Order) (จำนวน) พรรษา (ใน ภิกขุภาวะ หรือในเพศบรรพชิต)
ฐิติ	steadiness
อทินนาทาน	stealing
พระมุนี	Stilled One, the
โมไนย	stillness
มัจฉริยะ	stinginess
อุปจยะ	storing up
อุชุกตา, อาชชวะ	straightness
Stream-Enterer; Stream-Entrant; Stream-
โสดาบัน	Winner; Stream-Attainer
โสดาปัตติผล	Stream-Entry, fruition of
โสดาปัตติมรรค	Stream-Entry, path of
พละ	strength
ความเครียด, สารัทธภาวะ	stress
ปธาน, วิริยะ	striving
อันตราย, อันตรายิกธรรม	stumbling block
พรหมวิหาร	sublime states
ตทังคะ	substitution of opposites
อุปธิ	substratum of rebirth
สุขุม	subtle adj.
อิทธิ, สัมปัตติ	success
ทุกข์	suffering
สัปปายะ, กัปปิยะ, อนุรูป	suitable adj.
ฉัตร (ร่ม)	sunshade
อภิญญา	superknowledge
โลกุตตระ	supermundane; supramundane adj.
อิทธิปาฏิหาริย์	supernormal power
นิสสัย (ที่อาศัย); อุปถัมภ์	support
วิกขัมภนะ	suppression
พรหมวิหาร	supreme abidings
พรหมวิหาร	superme dwellings
อุกเขปนียกรรม	suspension
วิจาร	sustained application
มุทิตา	sympathetic joy
T
โผฏฐัพพะ	tactile object
อาสวะ	taint
อทินนาทาน	taking what is not given
ปิสุณวาจา, ปิสุณาวาจา, เปสุญวาท	tale-bearing
กถา	talk
ทมะ	taming
โผฏฐัพพารมณ์, โผฏฐัพพะ	tangible object
กิจ	task
รส	taste
อาจารย์	teacher
เทศนา, ธรรม	teaching
พระธรรม	Teaching; Teachings, the
เจโตปริยญาณ (เทียบ)	telepathy
จริต	temperament
อุตุ	temperature
มาร	Tempter, the
บท	term
วีมังสนะ	test
จตุกกะ (หมวดสี่)	tetrad
อนุโมทนา	thanking
เถรวาท (นิกายพระพุทธศาสนาดั้งเดิม ฝ่ายใต้ ปัจจุบัน คู่กับ มหายาน)	Theravada
ธัมมา, ธรรม	things
ตัณหา, ปิปาสา	thirst
จิต, จิตตุบาท, สังกัปป์, วิตักกะ	thought
วิตก	thought-conception
คันถะ	tie
ขันติ	tolerance
ชิวหา	tongue
มิทธะ	torpor
โผฏฐัพพะ	touch
พระคามวาสี	town-monk
สิกขา, ทมะ, ภาวนา	training
ไตรสิกขา	Training, the Threefold
สิกขาบท	training rule
ปัสสัทธิ, สมถะ	tranquillity
สมถภาวนา	Tranquillity Development
โลกุตตระ	transcendental
วิปริณาม	transformation
วีติกกมะ (การละเมิด)	transgression
อนิจจตา	transience; transiency
อนิจจ์, อนิจจัง	transient adj.
รัตนะ, นิธิ, ธนะ	treasure
ติกะ (หมวดสาม)	triad
พระรัตนตรัย	Triple Gem, the
ติกะ (หมวดสาม)	triplet
สัทธรรม	true doctrine
สัปบุรุษ, สัตบุรุษ	true man
สัจจะ	truth
ยมกปาฏิหาริย์	twin miracle; twin wonder
U
ปรมัตถ์	ultimate sense; ultimate reality
ดู supermundane	ultramundane
วิจิกิจฉา	uncertainty
อสังขตะ	uncompounded; unconditioned adj.
ภวังคจิต	unconscious mind
ภวังค์	unconscious state
อัพยากตะ, อัพยากฤต	undeclared
อนุสัย	underlying tendency
ปัญญา	understanding
สมาทาน. v. to undertake	undertaking
อนิยต	undetermined offence
เอกัคคตา	unification
อสังขาริก	uninstigated adj.
สามัคคี, เอกัตตะ, เอกีภาพ	unity
อัญญาณ	unknowing
อกุศล	unprofitable adj.
อสังขาริก	unprompted adj.
วิสมโลภ (= อภิชฌา)	unrighteous greed
อกุศล	unskilful adj.
อกุศลกรรม	unskilful action
อนุตตระ	unsurpassed adj.
อกุศล	unwholesome adj.
อกุศลกรรม	unwholesome action
นิรามิส	unworldly adj. 
สังเวคะ, สังเวช	urgency, sense of
โวหาร	usage
อุทาน, วจนะ	utterance
V
สัมผัปปลาปะ	vain talk
มทะ	vanity
ภูตคาม	vegetable-growth
คำเรียกนำหน้าชื่อพระสงฆ์แสดงคารวะ  นิยมใช้กับพระเถระหรือพระสงฆ์ทรงสมณศักดิ์ 	Venerable
(ย่อว่า Ven.)
คารวะ, นมะ, ปูชา	veneration
วจีกรรม	verbal action
วจีสังขาร	verbal formation; verbal functions
วจีสุจริต	verbal good conduct
วจีทุจริต	verbal misconduct
สติวินัย	verdict of innocence
อมูฬหวินัย	verdict of past insanity
สัมมุขาวินัย	verdict in the presence of
สัจฉิกิริยา, สัจฉิกรณะ	verification
คาถา	verse
วิสาขบูชา (นิยมใช้ในลังกาและอินเดีย = 	Vesak
Visākha Pūjā)
วาโยธาตุ	vibration, the element of
กรรมกิเลส	vices of conduct
ทิฏฐิ	view
คามวาสี	village-dweller
ศีล, คุณธรรม. adj. virtuous	virtue
สีลัพพตะ, ศีลและพรต	virtue and duty
สันทิฏฐิกะ	visible for oneself adj.
รูปารมณ์	visible object; visual object
ทัสสนะ	vision
อายุสังขาร	vital formation
ชีวิตินทรีย์	vitality
สุญญตา	void; voidness
เจตนา	volition
สังขาร	volitional activities
สลาก (สำหรับลงคะแนนเสียง)	voting-ticket
W
ชาคริยานุโยค	wakefulness
จงกรม	walking to and fro
จาริก	wander v.
การจาริก; สงสาร (เวียนว่ายตายเกิด)	wandering
ปริพาชก	wandering ascetic; wanderer
นักรบ, ขัตติยะ, ชนวรรณะกษัตริย์	warrior
ยาม	watch
อารักขา; ชาคริยะ	watchfulness
อาโป. ดู cohesion	water	
มรรค, ปฏิปทา	way
หิตสุข	weal
โภคะ, ธนะ	wealth
หิตสุข, ประโยชน์สุข	welfare
พระสุคต	Well-farer, the
วาจาสุภาษิต	well-spoken words
ภวจักร	wheel of becoming
ภวจักร	wheel of life
ธรรมจักร	Wheel of the Law
ธรรมจักร	Wheel of the Doctrine
สังสารจักร	wheel of rebirths
พระเจ้าจักรพรรดิ	wheel-turning monarch
กุศล	wholesome adj.
กุศลกรรม	wholesome action
บาป, ชั่ว	wicked adj.
กัมมัญญตา	wieldiness
ฉันทะ, เจตนา	will
วาโย	wind
ปัญญา	wisdom
บัณฑิต	wise man
ฉันทะ, อิจฉา (ความปรารถนา)	wish
อุพภาร, อุทธาร (การรื้อ, การถอน,  การเดาะ)	withdrawal
ทุกข์, อบาย	woe
ปาฏิหาริย์	wonder
ปุถุชน		worldling
สามิส	worldly
โลกีย์	worldly
โลกิยะ	worldly
โลกธรรม	worldly conditions
โลกธรรม	worldly vicissitudes
พระอรหันต์	worthy one
กุกกุจจะ	worry
โกธะ	wrath
ทุจริต	wrong conduct
อคติ	wrong course
ทุกกฏ	wrongdoing
มิจฉัตตะ	wrongness
อาบัติทุพภาสิต	wrong speech, offence of
วิกาล	wrong time
Y
อาสา (ความหวัง, ~ใฝ่หา)	yearning
ดู standing	years’ standing
กาสาวพัสตร์	yellow robe
โยคะ, ธุระ, ภาระ	yoke
Z
อัปปมาทะ	zeal
ฉันทะ	zeal
ปีติ	zest
